Позиция в рейтинге	Изменение позиции в рейтинге	Название банка	Номер лицензии	Регион регистрации	Декабрь, 2012, тыс. рублей	Январь, 2012, тыс. рублей	Изменение, тыс. рублей	Изменение, %
1	0	Сбербанк России	1481	Москва и обл.	13611685899	10975636300	2636049599	24.02
2	0	ВТБ	1000	Санкт-Петербург и обл.	4225872030	4209294510	16577520	0.39
3	0	Газпромбанк	354	Москва и обл.	2801570042	2458897495	342672547	13.94
4	0	Россельхозбанк	3349	Москва и обл.	1615112616	1466605876	148506740	10.13
5	0	Банк Москвы	2748	Москва и обл.	1513461083	1333451155	180009928	13.5
6	0	ВТБ 24	1623	Москва и обл.	1460127712	1215652461	244475251	20.11
7	0	Альфа-Банк	1326	Москва и обл.	1232046219	998169890	233876329	23.43
8	0	ЮниКредит Банк	1	Москва и обл.	830703742	894251608	-63547866	-7.11
9	0	Росбанк	2272	Москва и обл.	666371991	644809922	21562069	3.34
10	1	Промсвязьбанк	3251	Москва и обл.	652082203	589098990	62983213	10.69
11	-1	Райффайзенбанк	3292	Москва и обл.	597059444	594216497	2842947	0.48
12	1	ФК Открытие	2209	Москва и обл.	554095615	477551056	76544559	16.03
13	-1	Транскредитбанк	2142	Москва и обл.	506682198	511123981	-4441783	-0.87
14	0	Банк Уралсиб	2275	Москва и обл.	439411936	448379092	-8967156	-2
15	1	Банк «Санкт-Петербург»	436	Санкт-Петербург и обл.	364769398	342254428	22514970	6.58
16	3	Ситибанк	2557	Москва и обл.	359013594	284028682	74984912	26.4
17	-2	МДМ Банк	323	Новосибирская обл.	356146568	381509924	-25363356	-6.65
18	0	Ак Барс	2590	Татарстан	352164044	302471540	49692504	16.43
19	-2	Россия	328	Санкт-Петербург и обл.	314199470	306180265	8019205	2.62
20	12	Хоум Кредит Банк	316	Москва и обл.	293230412	164641833	128588579	78.1
21	6	Русский Стандарт	2289	Москва и обл.	281552901	193083078	88469823	45.82
22	-1	Московский Кредитный Банк	1978	Москва и обл.	280005476	237615707	42389769	17.84
23	-3	Нордеа Банк	3016	Москва и обл.	275291721	276713343	-1421622	-0.51
24	-1	Ханты-Мансийский банк Открытие	1971	Тюменская обл.	268789901	223246898	45543003	20.4
25	-3	Связь-Банк	1470	Москва и обл.	263269406	227180067	36089339	15.89
26	-1	Петрокоммерц	1776	Москва и обл.	245651574	203881417	41770157	20.49
27	-3	Зенит	3255	Москва и обл.	224445328	217670755	6774573	3.11
28	2	Глобэкс	1942	Москва и обл.	217495066	172604964	44890102	26.01
29	5	Восточный Экспресс Банк	1460	Амурская обл.	217341434	143248587	74092847	51.72
30	-2	ИНГ Банк	2495	Москва и обл.	211981099	189154552	22826547	12.07
31	-5	Возрождение	1439	Москва и обл.	205587584	193406116	12181468	6.3
32	-1	Банк «Открытие»	2179	Москва и обл.	183400946	171936436	11464510	6.67
33	-4	Национальный Банк «Траст»	3279	Москва и обл.	179120185	181765254	-2645069	-1.46
34	-1	МТС Банк	2268	Москва и обл.	174964645	147681560	27283085	18.47
35	1	Национальный Клиринговый Центр	3466	Москва и обл.	174644016	130518058	44125958	33.81
36	-1	Московский Индустриальный Банк	912	Москва и обл.	163465475	138862181	24603294	17.72
37	0	Бинбанк	2562	Москва и обл.	161634223	129856487	31777736	24.47
38	13	Дойче Банк	3328	Москва и обл.	160556039	97682745	62873294	64.36
39	-1	ОТП Банк	2766	Москва и обл.	151571569	126010660	25560909	20.28
40	5	Уральский Банк Реконструкции и Развития	429	Свердловская обл.	140966010	102833833	38132177	37.08
41	1	СМП Банк	3368	Москва и обл.	134264042	106952421	27311621	25.54
42	-2	СКБ-Банк	705	Свердловская обл.	133754670	115536742	18217928	15.77
43	-2	Транскапиталбанк (ТКБ)	2210	Москва и обл.	119445673	108801065	10644608	9.78
44	3	Новикомбанк	2546	Москва и обл.	118584979	102329377	16255602	15.89
45	-1	Национальный Расчетный Депозитарий	3294	Москва и обл.	116624817	106767220	9857597	9.23
46	3	Кредит Европа Банк	3311	Москва и обл.	115696673	101170386	14526287	14.36
47	-4	Русфинанс Банк	1792	Самарская обл.	113389093	106783650	6605443	6.19
48	9	Внешпромбанк	3261	Москва и обл.	110157303	89851736	20305567	22.6
49	-10	Абсолют Банк	2306	Москва и обл.	108006493	120953452	-12946959	-10.7
50	3	Пробизнесбанк	2412	Москва и обл.	107143370	95179572	11963798	12.57
51	3	РосЕвроБанк	3137	Москва и обл.	105378238	94522593	10855645	11.48
52	-6	МСП Банк	3340	Москва и обл.	103690226	102490168	1200058	1.17
53	-1	Инвестторгбанк	2763	Москва и обл.	102878954	95596617	7282337	7.62
54	7	Татфондбанк	3058	Татарстан	100925143	82659350	18265793	22.1
55	4	Авангард	2879	Москва и обл.	100677482	84061159	16616323	19.77
56	-6	Росгосстрах Банк	3073	Москва и обл.	99602987	98150815	1452172	1.48
57	19	Совкомбанк	963	Костромская обл.	95823079	59334007	36489072	61.5
58	20	Эйч-Эс-Би-Си Банк (HSBC)	3290	Москва и обл.	95580181	57902951	37677230	65.07
59	10	Российский Капитал	2312	Москва и обл.	94762458	67180965	27581493	41.06
60	12	Ренессанс Кредит	3354	Москва и обл.	92112096	63998407	28113689	43.93
61	-13	БНП Париба Банк	3407	Москва и обл.	91187564	101447382	-10259818	-10.11
62	-6	Юниаструм Банк	2771	Москва и обл.	90323866	90804451	-480585	-0.53
63	0	КИТ Финанс Инвестиционный Банк	1911	Санкт-Петербург и обл.	89445521	78911663	10533858	13.35
64	11	Азиатско-Тихоокеанский Банк	1810	Амурская обл.	88158945	59498888	28660057	48.17
65	-10	Банк Интеза	2216	Москва и обл.	85341980	93076210	-7734230	-8.31
66	7	Пересвет	2110	Москва и обл.	82918004	63893822	19024182	29.77
67	-7	Балтийский Банк	128	Москва и обл.	82897560	82971654	-74094	-0.09
68	-10	Союз	2307	Москва и обл.	79725011	86098422	-6373411	-7.4
69	-5	Запсибкомбанк	918	Тюменская обл.	78250348	78772349	-522001	-0.66
70	1	ДельтаКредит	3338	Москва и обл.	75515013	65322035	10192978	15.6
71	52	Банк Кредит Свисс	2494	Москва и обл.	73845420	27155356	46690064	171.94
72	-7	Собинбанк	1317	Москва и обл.	72898793	74273913	-1375120	-1.85
73	-6	Еврофинанс Моснарбанк	2402	Москва и обл.	72546089	69322020	3224069	4.65
74	19	Связной Банк	1961	Москва и обл.	72333021	40155995	32177026	80.13
75	-13	Мастер-Банк	2176	Москва и обл.	71803891	79086982	-7283091	-9.21
76	-10	Всероссийский Банк Развития Регионов	3287	Москва и обл.	70962449	73099945	-2137496	-2.92
77	30	Тинькофф Банк	2673	Москва и обл.	68425950	31438653	36987297	117.65
78	-4	Локо-Банк	2707	Москва и обл.	68159593	61765101	6394492	10.35
79	-9	ЦентроКредит	121	Москва и обл.	65649436	66247394	-597958	-0.9
80	-12	Фондсервисбанк	2989	Москва и обл.	63782329	68518768	-4736439	-6.91
81	-2	Центр-инвест	2225	Ростовская обл.	63551806	57703978	5847828	10.13
82	-5	Балтинвестбанк	3176	Санкт-Петербург и обл.	60534116	59136579	1397537	2.36
83	-1	Креди Агриколь КИБ	1680	Санкт-Петербург и обл.	59312960	54367850	4945110	9.1
84	-3	Королевский Банк Шотландии	2594	Москва и обл.	57605506	57318278	287228	0.5
85	10	Первобанк	3461	Самарская обл.	57114475	38907455	18207020	46.8
86	-1	Нота-Банк	2913	Москва и обл.	54662342	52378243	2284099	4.36
87	-7	Международный Банк Санкт-Петербурга (МБСП)	197	Санкт-Петербург и обл.	54397455	57425415	-3027960	-5.27
88	-4	Металлинвестбанк	2440	Москва и обл.	54394977	53763169	631808	1.18
89	0	Инвестбанк	107	Москва и обл.	53939100	43549769	10389331	23.86
90	2	Сургутнефтегазбанк	588	Тюменская обл.	51889916	40293494	11596422	28.78
91	-8	Меткомбанк (Каменск-Уральский)	2443	Свердловская обл.	51549244	54312894	-2763650	-5.09
92	-1	Международный Финансовый Клуб	2618	Москва и обл.	50530568	42123214	8407354	19.96
93	-3	Национальный Стандарт	3421	Москва и обл.	50079190	42402748	7676442	18.1
94	-6	СБ Банк (Судостроительный банк)	2999	Москва и обл.	49875030	46021152	3853878	8.37
95	-1	Бинбанк кредитные карты	2827	Москва и обл.	48821228	39706703	9114525	22.95
96	15	Банк БФА	3038	Санкт-Петербург и обл.	47917718	30637176	17280542	56.4
97	2	Таврический	2304	Санкт-Петербург и обл.	45865357	35653575	10211782	28.64
98	19	Московский Областной Банк	1751	Москва и обл.	41894321	28641189	13253132	46.27
99	34	Тойота Банк	3470	Москва и обл.	41201591	24353492	16848099	69.18
100	4	Экспресс-Волга	3085	Саратовская обл.	41177480	33005111	8172369	24.76
101	0	Интеркоммерц Банк	1657	Москва и обл.	40318588	34241640	6076948	17.75
102	0	Кубань Кредит	2518	Краснодарский край	38670814	33295776	5375038	16.14
103	9	Народный Кредит	2401	Москва и обл.	36106872	29209855	6897017	23.61
104	-17	Национальный Резервный Банк	2170	Москва и обл.	34859147	47375747	-12516600	-26.42
105	0	Челябинвестбанк	493	Челябинская обл.	34681591	32115876	2565715	7.99
106	2	Челиндбанк	485	Челябинская обл.	33801001	31097842	2703159	8.69
107	20	Меткомбанк (Череповец)	901	Вологодская обл.	33346959	25621418	7725541	30.15
108	6	Межтопэнергобанк	2956	Москва и обл.	33281893	29138158	4143735	14.22
109	19	Примсоцбанк	2733	Приморский край	33278390	25618198	7660192	29.9
110	3	Кедр	1574	Москва и обл.	32350204	29200657	3149547	10.79
111	24	Кольцо Урала	65	Свердловская обл.	32221046	23919251	8301795	34.71
112	-12	Дальневосточный Банк	843	Приморский край	32165930	34387947	-2222017	-6.46
113	13	Русский Международный Банк	3123	Москва и обл.	32010093	25822380	6187713	23.96
114	2	Саровбизнесбанк	2048	Нижегородская обл.	31674097	28673192	3000905	10.47
115	-5	СДМ-Банк	1637	Москва и обл.	31418967	31067370	351597	1.13
116	8	Фора-Банк	1885	Москва и обл.	31300708	27133018	4167690	15.36
117	17	Смоленский Банк	2029	Смоленская обл.	30812600	24204116	6608484	27.3
118	7	Банк СГБ	2816	Вологодская обл.	30622150	26868619	3753531	13.97
119	-21	Стройкредит	18	Москва и обл.	30560099	36104781	-5544682	-15.36
120	-17	НС Банк	3124	Москва и обл.	30245231	33135989	-2890758	-8.72
121	0	Крайинвестбанк	3360	Краснодарский край	30204341	28053496	2150845	7.67
122	-2	Интерпромбанк	3266	Москва и обл.	30180180	28413884	1766296	6.22
123	-14	Современный Коммерческий Банк (бывш. ДжиИ Мани Банк)	3316	Москва и обл.	29745707	31080804	-1335097	-4.3
124	-2	Первый Республиканский Банк	1730	Москва и обл.	29612199	27311607	2300592	8.42
125	17	Пушкино	391	Москва и обл.	29096879	22027869	7069010	32.09
126	-8	Газбанк	2316	Самарская обл.	29080392	28594216	486176	1.7
127	23	Левобережный	1343	Новосибирская обл.	28962705	19996155	8966550	44.84
128	-31	Коммерцбанк (Евразия)	3333	Москва и обл.	28406135	37269821	-8863686	-23.78
129	11	М2М Прайвет Банк	1414	Москва и обл.	28088348	22292903	5795445	26
130	102	Сетелем Банк	2168	Москва и обл.	27937168	10796235	17140933	158.77
131	17	Натиксис Банк	3390	Москва и обл.	27557534	20346693	7210841	35.44
132	9	Мой Банк	2939	Москва и обл.	27425182	22228292	5196890	23.38
133	13	Росэнергобанк	2211	Москва и обл.	27367796	21516773	5851023	27.19
134	-4	Банк АВБ	23	Самарская обл.	27247096	25220454	2026642	8.04
135	3	АМБ Банк	3036	Москва и обл.	27160746	23105960	4054786	17.55
136	30	Экспобанк	2998	Москва и обл.	26783836	17075539	9708297	56.85
137	2	Банк «МБА-Москва»	3395	Москва и обл.	26372925	22658270	3714655	16.39
138	-2	БФГ-Кредит	3068	Москва и обл.	26021159	23669476	2351683	9.94
139	4	Агропромкредит	2880	Москва и обл.	25703217	21676688	4026529	18.58
140	-8	Липецккомбанк	1242	Липецкая обл.	25237631	24362595	875036	3.59
141	10	ГПБ-Ипотека	2403	Москва и обл.	24529972	19936859	4593113	23.04
142	26	Интерпрогрессбанк	600	Москва и обл.	24260906	16633902	7627004	45.85
143	65	Российский Кредит	324	Москва и обл.	24248967	12508206	11740761	93.86
144	-7	Акибанк	2587	Татарстан	24207391	23630833	576558	2.44
145	-1	Девон-Кредит	1972	Татарстан	24042000	21628812	2413188	11.16
146	57	Рост	2589	Москва и обл.	23958605	12697460	11261145	88.69
147	-16	Москоммерцбанк	3365	Москва и обл.	23628586	24737578	-1108992	-4.48
148	-19	Приморье	3001	Приморский край	23531891	25498066	-1966175	-7.71
149	0	Банк Проектного Финансирования	1677	Москва и обл.	23320233	20104855	3215378	15.99
150	-5	Альта-Банк	2269	Москва и обл.	22828652	21551007	1277645	5.93
151	11	БыстроБанк	1745	Удмуртия	22822463	17614334	5208129	29.57
152	27	Мир Бизнес Банк	3396	Москва и обл.	22702493	15092189	7610304	50.43
153	11	БМВ Банк	3482	Москва и обл.	22530297	17515839	5014458	28.63
154	67	Аверс	415	Татарстан	21884358	11783380	10100978	85.72
155	-8	Кредит Урал Банк	2584	Челябинская обл.	21790320	20966287	824033	3.93
156	-50	Сведбанк	3064	Москва и обл.	21695933	31711320	-10015387	-31.58
157	45	Советский	558	Санкт-Петербург и обл.	21627840	12785939	8841901	69.15
158	109	РосинтерБанк	226	Москва и обл.	21548807	8599507	12949300	150.58
159	-1	Образование	1521	Москва и обл.	21536447	18539978	2996469	16.16
160	-8	ФИА-Банк	2542	Самарская обл.	21475961	19761044	1714917	8.68
161	-8	Солидарность (Самара)	554	Самарская обл.	21364806	19655915	1708891	8.69
162	-5	Региональный Кредит	1927	Костромская обл.	21206711	18682523	2524188	13.51
163	8	Сумитомо Мицуи	3494	Москва и обл.	20787240	16504036	4283204	25.95
164	-3	Русстройбанк	3205	Москва и обл.	20751241	17694212	3057029	17.28
165	24	Мосстройэкономбанк (М Банк)	948	Москва и обл.	20739833	13943693	6796140	48.74
166	-11	С банк	2581	Москва и обл.	20697144	18732824	1964320	10.49
167	-13	Тимер Банк	1581	Татарстан	20331300	18795052	1536248	8.17
168	38	Огни Москвы	2328	Москва и обл.	20275514	12537099	7738415	61.72
169	-13	Уральский Финансовый Дом	249	Пермская обл.	20268282	18683393	1584889	8.48
170	-5	Первый Чешско-Российский Банк	3291	Москва и обл.	20185213	17205939	2979274	17.32
171	-8	Спурт Банк	2207	Татарстан	19999865	17612918	2386947	13.55
172	1	Европейский Трастовый Банк	2968	Москва и обл.	19814043	15615039	4199004	26.89
173	187	Фольксваген Банк Рус	3500	Москва и обл.	19097022	4988344	14108678	282.83
174	9	ББР Банк	2929	Москва и обл.	18685752	14747189	3938563	26.71
175	-3	Банк РСБ 24 (Русславбанк)	1073	Москва и обл.	18651888	16070478	2581410	16.06
176	39	Пойдем!	2534	Москва и обл.	18428874	12040286	6388588	53.06
177	-17	НОМОС-Региобанк	539	Хабаровский край	18216546	17801975	414571	2.33
178	-8	Морской Банк	77	Москва и обл.	17851798	16526233	1325565	8.02
179	49	Финпромбанк (ФПБ Банк)	2157	Москва и обл.	17578387	10975690	6602697	60.16
180	44	МАСТ-Банк	3267	Москва и обл.	17307746	11519119	5788627	50.25
181	-14	Энергобанк	67	Татарстан	17279069	16681880	597189	3.58
182	-23	Уралтрансбанк	812	Свердловская обл.	17238246	17888458	-650212	-3.63
183	-2	Легион	3117	Москва и обл.	17185161	14841685	2343476	15.79
184	14	Рост Банк	2888	Татарстан	17057609	13275779	3781830	28.49
185	-7	Инвесткапиталбанк	2377	Башкортостан	16772188	15246995	1525193	10
186	2	Интехбанк	2705	Татарстан	16419668	14006552	2413116	17.23
187	43	Мерседес-Бенц Банк Рус	3473	Москва и обл.	16333176	10936930	5396246	49.34
188	9	БКС — Инвестиционный Банк	101	Новосибирская обл.	16146457	13334445	2812012	21.09
189	7	Фининвест	671	Москва и обл.	16071216	13372645	2698571	20.18
190	-10	Развитие-Столица	3013	Москва и обл.	16061084	14898447	1162637	7.8
191	-1	Алмазэргиэнбанк	2602	Саха (Якутия)	16019734	13929814	2089920	15
192	34	Форштадт	2208	Оренбургская обл.	16015705	11224676	4791029	42.68
193	48	Плюс Банк	1189	Омская обл.	15973762	9914614	6059148	61.11
194	-18	НБД-Банк	1966	Нижегородская обл.	15782067	15314378	467689	3.05
195	16	Первомайский	518	Краснодарский край	15590778	12220472	3370306	27.58
196	-19	Курскпромбанк	735	Курская обл.	15506915	15266060	240855	1.58
197	-28	Петербургский Социальный Коммерческий Банк	2551	Санкт-Петербург и обл.	15466220	16566895	-1100675	-6.64
198	21	Тольяттихимбанк	2507	Самарская обл.	15352762	11815219	3537543	29.94
199	18	Газэнергобанк	3252	Калужская обл.	15314952	11921006	3393946	28.47
200	-9	Эллипс Банк	1950	Нижегородская обл.	15256305	13895702	1360603	9.79
201	-17	Ланта-Банк	1920	Москва и обл.	15244349	14516652	727697	5.01
202	-28	Норвик Банк	902	Кировская обл.	15241072	15489811	-248739	-1.61
203	-11	Новокузнецкий Муниципальный Банк	2865	Кемеровская обл.	15114218	13832391	1281827	9.27
204	1	Энергомашбанк	52	Санкт-Петербург и обл.	15080938	12580153	2500785	19.88
205	17	Банк ПСА Финанс Рус	3481	Москва и обл.	14897106	11644179	3252927	27.94
206	-7	Энерготрансбанк	1307	Калининградская обл.	14557309	13195400	1361909	10.32
207	-25	Александровский	53	Санкт-Петербург и обл.	14441113	14771737	-330624	-2.24
208	-4	Гаранти Банк — Москва	3275	Москва и обл.	14272346	12592360	1679986	13.34
209	20	Балтика	967	Санкт-Петербург и обл.	14272123	10956085	3316038	30.27
210	-35	Гута-Банк	256	Москва и обл.	14238546	15376840	-1138294	-7.4
211	-10	ВУЗ-Банк	1557	Свердловская обл.	14197275	12871987	1325288	10.3
212	-17	Западный	2598	Москва и обл.	14192589	13512541	680048	5.03
213	-20	Центркомбанк	2983	Москва и обл.	14051006	13786729	264277	1.92
214	37	АктивКапитал Банк	3006	Самарская обл.	13886022	9521784	4364238	45.83
215	27	ЯР-Банк	3185	Москва и обл.	13669767	9909842	3759925	37.94
216	-9	Держава	2738	Москва и обл.	13562359	12523896	1038463	8.29
217	-7	АйМаниБанк	1975	Республика Алтай	13552823	12368141	1184682	9.58
218	-6	Алеф-Банк	2119	Москва и обл.	13423878	12206689	1217189	9.97
219	119	Военно-Промышленный Банк	3065	Москва и обл.	13336976	5588977	7747999	138.63
220	5	ТЭМБР-Банк	2764	Москва и обл.	12961875	11334950	1626925	14.35
221	-21	Национальная Факторинговая Компания	3437	Москва и обл.	12880948	12899671	-18723	-0.15
222	-8	Гранд Инвест Банк	3053	Москва и обл.	12757727	12150770	606957	5
223	20	Расчетно-Кредитный Банк	103	Москва и обл.	12663502	9844556	2818946	28.63
224	7	Хлынов	254	Кировская обл.	12492730	10817736	1674994	15.48
225	-31	Платежный Центр	3166	Новосибирская обл.	12348755	13738850	-1390095	-10.12
226	11	Интрастбанк	3144	Москва и обл.	12330353	10543411	1786942	16.95
227	55	АйСиБиСи Банк	3475	Москва и обл.	12305954	8036798	4269156	53.12
228	-15	Нацинвестпромбанк	3077	Москва и обл.	12259413	12183643	75770	0.62
229	24	Национальный Банк Развития Бизнеса	2795	Москва и обл.	11979232	9415456	2563776	27.23
230	-7	СтарБанк	548	Москва и обл.	11791196	11547742	243454	2.11
231	21	СИАБ	3245	Санкт-Петербург и обл.	11684742	9468756	2215986	23.4
232	-23	Росдорбанк	1573	Москва и обл.	11641884	12394531	-752647	-6.07
233	-15	Экопромбанк	2011	Пермская обл.	11595770	11855809	-260039	-2.19
234	-14	Солидарность (Москва)	1555	Москва и обл.	11562735	11783588	-220853	-1.87
235	-1	Московское Ипотечное Агентство	3344	Москва и обл.	11428635	10615612	813023	7.66
236	28	РусЮгбанк	2093	Волгоградская обл.	11293129	8721254	2571875	29.49
237	-50	Углеметбанк	2997	Челябинская обл.	11053571	14227232	-3173661	-22.31
238	34	Экспресс	3084	Дагестан	10971392	8537210	2434182	28.51
239	168	Банк Расчетов и Сбережений	2617	Москва и обл.	10865133	4134459	6730674	162.79
240	17	Денизбанк Москва	3330	Москва и обл.	10793521	9163391	1630130	17.79
241	34	МАК-Банк	1088	Москва и обл.	10779540	8505735	2273805	26.73
242	-26	Банк24.ру	2227	Свердловская обл.	10766895	12021557	-1254662	-10.44
243	-10	НК Банк	2755	Москва и обл.	10717592	10743810	-26218	-0.24
244	2	Ури Банк	3479	Москва и обл.	10709195	9703704	1005491	10.36
245	2	Экономбанк	1319	Саратовская обл.	10686400	9699487	986913	10.17
246	-7	Прио-Внешторгбанк	212	Рязанская обл.	10662888	10275486	387402	3.77
247	21	Акцепт	567	Новосибирская обл.	10651011	8594964	2056047	23.92
248	73	Транснациональный Банк	2108	Москва и обл.	10585663	5993327	4592336	76.62
249	-1	Европейский	1616	Калининградская обл.	10585094	9695771	889323	9.17
250	19	Международный Акционерный Банк	1987	Москва и обл.	10398848	8561744	1837104	21.46
251	-11	Бэнк оф Чайна	2309	Москва и обл.	10385965	10114375	271590	2.69
252	133	ОФК Банк	2270	Москва и обл.	10327366	4579421	5747945	125.52
253	-26	Социнвестбанк	1132	Башкортостан	10268526	11032369	-763843	-6.92
254	-68	Аресбанк	2914	Москва и обл.	10260731	14293608	-4032877	-28.21
255	24	БайкалБанк	2632	Бурятия	10134323	8238061	1896262	23.02
256	-2	Гарант-Инвест	2576	Москва и обл.	10115373	9366711	748662	7.99
257	26	НОМОС-Банк-Сибирь	410	Новосибирская обл.	10000951	7956116	2044835	25.7
258	28	Унифин	2654	Москва и обл.	9945750	7859197	2086553	26.55
259	36	Росавтобанк	2767	Москва и обл.	9886931	7230405	2656526	36.74
260	-24	Адмиралтейский	3054	Москва и обл.	9795300	10547067	-751767	-7.13
261	42	Русский Ипотечный Банк	1968	Москва и обл.	9759848	6828405	2931443	42.93
262	-13	Роспромбанк	3204	Москва и обл.	9726659	9557853	168806	1.77
263	153	Банк Город	2644	Москва и обл.	9649573	3960342	5689231	143.66
264	-20	Росэксимбанк	2790	Москва и обл.	9629756	9841059	-211303	-2.15
265	1	Промсбербанк	1043	Москва и обл.	9592766	8678896	913870	10.53
266	4	Екатеринбург	3161	Свердловская обл.	9528831	8557548	971283	11.35
267	14	Международный Банк Развития	2704	Москва и обл.	9455037	8132242	1322795	16.27
268	-3	Нефтяной Альянс	2859	Москва и обл.	9440011	8691884	748127	8.61
269	43	Темпбанк	55	Москва и обл.	9401027	6352311	3048716	47.99
270	-25	Оренбург	3269	Оренбургская обл.	9310292	9742488	-432196	-4.44
271	-21	Рублев	3098	Москва и обл.	9207946	9539388	-331442	-3.47
272	-10	Руснарбанк	3403	Москва и обл.	9150859	8843920	306939	3.47
273	11	Белгородсоцбанк	760	Белгородская обл.	9135345	7920096	1215249	15.34
274	54	Ю Би Эс Банк	3463	Москва и обл.	9109443	5793589	3315854	57.23
275	2	Данске Банк	3307	Санкт-Петербург и обл.	9079022	8327276	751746	9.03
276	14	Метробанк	2548	Москва и обл.	8991087	7613250	1377837	18.1
277	-6	Башинвестбанк	2189	Башкортостан	8967904	8556916	410988	4.8
278	-20	Новосибирский Муниципальный Банк	2786	Новосибирская обл.	8828330	9151150	-322820	-3.53
279	60	Миллениум Банк	3423	Москва и обл.	8827962	5582635	3245327	58.13
280	7	Первый Экспресс	3237	Тульская обл.	8722123	7713954	1008169	13.07
281	7	Кредит-Москва	5	Москва и обл.	8687475	7673528	1013947	13.21
282	48	Монолит	1967	Москва и обл.	8681627	5720788	2960839	51.76
283	2	Башкомснаббанк	1398	Башкортостан	8607359	7889231	718128	9.1
284	91	Генбанк	2490	Москва и обл.	8593665	4704347	3889318	82.67
285	19	Банк БЦК-Москва	3480	Москва и обл.	8554821	6748218	1806603	26.77
286	12	ОПМ-Банк	2734	Москва и обл.	8428005	7174640	1253365	17.47
287	39	Уралкапиталбанк	2519	Башкортостан	8351835	5864488	2487347	42.41
288	-33	Банк Жилищного Финансирования	3138	Москва и обл.	8241066	9285549	-1044483	-11.25
289	42	Банк Торгового Финансирования	1982	Москва и обл.	8190713	5689974	2500739	43.95
290	142	Русский Земельный Банк	2810	Москва и обл.	8149956	3628225	4521731	124.63
291	1	Волго-Камский Банк	282	Самарская обл.	8047887	7577777	470110	6.2
292	135	Транспортный	3174	Москва и обл.	8020312	3755211	4265101	113.58
293	-178	Расчетная Палата РТС	3335	Москва и обл.	7999225	29010697	-21011472	-72.43
294	-35	Евромет	2902	Москва и обл.	7808405	9059015	-1250610	-13.81
295	-1	АФ Банк	991	Башкортостан	7801611	7341418	460193	6.27
296	11	Тусар	2712	Москва и обл.	7798693	6638523	1160170	17.48
297	2	КС Банк	1752	Мордовия	7761414	7153434	607980	8.5
298	97	Клиентский	2324	Москва и обл.	7714635	4367456	3347179	76.64
299	-39	СЭБ Банк	3235	Санкт-Петербург и обл.	7628822	8882216	-1253394	-14.11
300	-62	Русьуниверсалбанк	3293	Москва и обл.	7614473	10451200	-2836727	-27.14
301	18	Волга-Кредит	1153	Самарская обл.	7535043	6044945	1490098	24.65
302	-11	Северо-Восточный Альянс	2768	Москва и обл.	7506203	7589461	-83258	-1.1
303	-3	Нико-Банк	702	Оренбургская обл.	7489469	7074981	414488	5.86
304	-30	Снежинский	1376	Челябинская обл.	7447758	8506485	-1058727	-12.45
305	20	Солид Банк	1329	Камчатская обл.	7433527	5865186	1568341	26.74
306	-1	Хованский	2145	Москва и обл.	7382224	6712973	669251	9.97
307	-14	Кузнецкбизнесбанк	1158	Кемеровская обл.	7359359	7349928	9431	0.13
308	-52	Современный Коммерческий Ипотечный Банк	3329	Москва и обл.	7347023	9166378	-1819355	-19.85
309	13	Бенифит-Банк	3229	Москва и обл.	7337333	5933824	1403509	23.65
310	48	Дил-Банк	3384	Москва и обл.	7313975	5036724	2277251	45.21
311	-2	Автоторгбанк	2776	Москва и обл.	7306551	6549935	756616	11.55
312	6	ПИР Банк	2655	Москва и обл.	7159465	6119574	1039891	16.99
313	-17	Финам Банк	2799	Москва и обл.	7012013	7227954	-215941	-2.99
314	31	Ишбанк	2867	Москва и обл.	6969690	5497317	1472373	26.78
315	68	Финансовый Стандарт	1053	Москва и обл.	6874597	4597667	2276930	49.52
316	46	Ренессанс	1939	Москва и обл.	6872273	4940842	1931431	39.09
317	83	Развитие	2729	Карачаево-Черкесия	6835182	4299576	2535606	58.97
318	9	Экспресс-Кредит	210	Москва и обл.	6807617	5863698	943919	16.1
319	-39	Новый Московский Банк	2932	Москва и обл.	6805653	8172805	-1367152	-16.73
320	-7	Югра	880	Тюменская обл.	6785789	6327047	458742	7.25
321	30	Альба Альянс	2593	Москва и обл.	6775967	5244549	1531418	29.2
322	-137	Замоскворецкий	1640	Москва и обл.	6771040	14512907	-7741867	-53.34
323	59	Промтрансбанк	2638	Башкортостан	6708136	4617739	2090397	45.27
324	-63	Вега-Банк	3270	Москва и обл.	6580120	8850495	-2270375	-25.65
325	-36	Ставропольпромстройбанк	1288	Ставропольский край	6541331	7617808	-1076477	-14.13
326	37	Дагэнергобанк	3286	Дагестан	6530372	4876290	1654082	33.92
327	16	Автоградбанк	1455	Татарстан	6528729	5540804	987925	17.83
328	-31	Банк Инноваций и Развития	2647	Москва и обл.	6515829	7212541	-696712	-9.66
329	-27	Русь	704	Оренбургская обл.	6502736	6901464	-398728	-5.78
330	-19	Томскпромстройбанк	1720	Томская обл.	6481493	6465561	15932	0.25
331	79	Тихоокеанский Внешторгбанк	1378	Сахалинская обл.	6467832	4053300	2414532	59.57
332	-16	Рускобанк	138	Санкт-Петербург и обл.	6465668	6181668	284000	4.59
333	-27	Япы Креди Банк Москва	2555	Москва и обл.	6395709	6654832	-259123	-3.89
334	-33	Славия	2664	Москва и обл.	6378922	6945131	-566209	-8.15
335	-21	Ижкомбанк	646	Удмуртия	6349967	6253260	96707	1.55
336	-1	ЕвроситиБанк	1869	Ставропольский край	6327226	5655488	671738	11.88
337	-5	Бинбанк Тверь	777	Тверская обл.	6222825	5685146	537679	9.46
338	11	Эксперт Банк	2949	Омская обл.	6220911	5294141	926770	17.51
339	-61	Международный Коммерческий Банк	2524	Москва и обл.	6133659	8269413	-2135754	-25.83
340	-16	Банк Казани	708	Татарстан	6126559	5881030	245529	4.17
341	39	Агросоюз	1459	Москва и обл.	6085728	4634991	1450737	31.3
342	-27	Славянский Кредит	2960	Москва и обл.	6063374	6246599	-183225	-2.93
343	10	Юг-Инвестбанк	2772	Краснодарский край	6034947	5197310	837637	16.12
344	27	Национальный Залоговый Банк	2944	Москва и обл.	5987920	4738281	1249639	26.37
345	21	Софрино	2972	Москва и обл.	5952352	4790718	1161634	24.25
346	-17	Муниципальный Камчатпрофитбанк	2103	Камчатская обл.	5936280	5767512	168768	2.93
347	-24	Банк Оранжевый	1659	Санкт-Петербург и обл.	5918891	5892917	25974	0.44
348	21	Экономикс-Банк	2136	Москва и обл.	5888372	4767884	1120488	23.5
349	16	Банк БФТ	2273	Москва и обл.	5876444	4841835	1034609	21.37
350	-77	Тройка-Д Банк	3431	Москва и обл.	5840998	8532300	-2691302	-31.54
351	-3	ФДБ	3071	Москва и обл.	5737681	5294559	443122	8.37
352	18	Белгородпромстройбанк	1816	Белгородская обл.	5727420	4760861	966559	20.3
353	3	Трансстройбанк	2807	Москва и обл.	5699185	5116964	582221	11.38
354	-13	Объединенный Банк Промышленных Инвестиций	2626	Москва и обл.	5685927	5558592	127335	2.29
355	-22	Волжский Социальный Банк	2428	Самарская обл.	5676960	5678330	-1370	-0.02
356	-93	Киви Банк	2241	Москва и обл.	5671151	8820563	-3149412	-35.71
357	4	Московский Нефтехимический Банк	1411	Москва и обл.	5592208	4973494	618714	12.44
358	100	Татсоцбанк	480	Татарстан	5565030	3101525	2463505	79.43
359	-83	Платина	2347	Москва и обл.	5546312	8466598	-2920286	-34.49
360		Региональный Банк Развития — Московский филиал	2782	Россия	5529226			
361	-15	Руссобанк	2313	Москва и обл.	5526202	5440183	86019	1.58
362	-45	Банк на Красных Воротах	2472	Москва и обл.	5433871	6153655	-719784	-11.7
363	54	Нижневолжский Коммерческий Банк	931	Саратовская обл.	5432410	3939646	1492764	37.89
364	17	Голдман Сакс Банк	3490	Москва и обл.	5421994	4621385	800609	17.32
365	-8	Бинбанк Мурманск	1276	Мурманская обл.	5396870	5067186	329684	6.51
366	-58	Банк Финсервис	3388	Москва и обл.	5384689	6593842	-1209153	-18.34
367	305	РЕСО Кредит	3450	Москва и обл.	5342646	1323291	4019355	303.74
368	11	Чувашкредитпромбанк	1280	Чувашия	5327010	4648594	678416	14.59
369	-10	Ассоциация	732	Нижегородская обл.	5309099	5026935	282164	5.61
370	24	Вокбанк	312	Нижегородская обл.	5265948	4369188	896760	20.52
371	21	Анкор Банк	889	Татарстан	5243414	4432120	811294	18.3
372	-18	Северный Народный Банк	2721	Коми	5236730	5186019	50711	0.98
373	36	Русский Торговый Банк	2842	Москва и обл.	5212184	4072608	1139576	27.98
374	-38	Банк Раунд	2506	Москва и обл.	5167671	5654264	-486593	-8.61
375	2	Лесбанк	1598	Москва и обл.	5160373	4689707	470666	10.04
376	-4	Риабанк	3434	Москва и обл.	5156165	4733884	422281	8.92
377	-30	Кремлевский	2905	Москва и обл.	5151103	5333308	-182205	-3.42
378	6	Сибнефтебанк	385	Тюменская обл.	5141097	4590247	550850	12
379	-42	Актив Банк	2529	Мордовия	5117299	5648331	-531032	-9.4
380	-28	Профит Банк	3234	Москва и обл.	5068050	5220419	-152369	-2.92
381	23	Джей энд Ти Банк	3061	Москва и обл.	5065445	4217289	848156	20.11
382	7	Банк Развития Региона	3315	Северная Осетия — Алания	5042345	4460394	581951	13.05
383	5	Нэклис-Банк	1671	Москва и обл.	5023999	4479967	544032	12.14
384	-34	Веста	2368	Москва и обл.	5023467	5291046	-267579	-5.06
385	-7	Бинбанк Смоленск	1957	Смоленская обл.	4993895	4670595	323300	6.92
386	10	Зернобанк	2337	Алтайский край	4956632	4349881	606751	13.95
387	-32	Банк Развития Технологий	3441	Москва и обл.	4950525	5140648	-190123	-3.7
388	33	Камский Коммерческий Банк	438	Татарстан	4933782	3891991	1041791	26.77
389	-15	Сибсоцбанк	2015	Алтайский край	4920216	4716011	204205	4.33
390	32	Торгово-Строительный Банк	1250	Москва и обл.	4893240	3831965	1061275	27.7
391	27	БайкалИнвестБанк	1067	Иркутская обл.	4859008	3926536	932472	23.75
392	207	Навигатор	2469	Москва и обл.	4824491	1743718	3080773	176.68
393	48	Объединенный Кредитный Банк	1118	Владимирская обл.	4755458	3351129	1404329	41.91
394	-4	Мой Банк. Ипотека	2436	Башкортостан	4744530	4449989	294541	6.62
395	-75	Кузнецкий Мост	2254	Москва и обл.	4660554	6026858	-1366304	-22.67
396	55	2Т Банк	625	Москва и обл.	4657987	3230401	1427586	44.19
397	43	Спецсетьстройбанк	3062	Москва и обл.	4641127	3376116	1265011	37.47
398	50	Стромкомбанк	404	Красноярский край	4556976	3241558	1315418	40.58
399	7	Банк БКФ	2684	Москва и обл.	4541122	4179764	361358	8.65
400	11	ВостСибтранскомбанк	2731	Иркутская обл.	4499453	4050843	448610	11.07
401	12	Юникорбанк	2586	Москва и обл.	4439343	3984127	455216	11.43
402	26	Кранбанк	2271	Ивановская обл.	4436349	3709722	726627	19.59
403	11	Век	2299	Москва и обл.	4409421	3965307	444114	11.2
404	340	Объединенный Капитал	2611	Санкт-Петербург и обл.	4407536	918527	3489009	379.85
405	-37	Банкхаус Эрбе	1717	Москва и обл.	4400858	4780274	-379416	-7.94
406	124	Таатта	1249	Саха (Якутия)	4368236	2398945	1969291	82.09
407	16	Промэнергобанк	2728	Вологодская обл.	4339758	3811192	528566	13.87
408	53	Межтрастбанк	2493	Москва и обл.	4333962	3073988	1259974	40.99
409	21	Ермак	1809	Тюменская обл.	4328525	3668124	660401	18
410	42	Инвестиционный Союз	637	Москва и обл.	4276592	3210038	1066554	33.23
411	13	Зенит Сочи	232	Краснодарский край	4222613	3786823	435790	11.51
412	443	Анталбанк	3115	Москва и обл.	4210533	475529	3735004	785.44
413	21	Хакасский Муниципальный Банк	1049	Хакасия	4167018	3588865	578153	16.11
414	-72	Проминвестбанк	2433	Москва и обл.	4117482	5557354	-1439872	-25.91
415	-13	Межрегиональный Почтовый Банк	3171	Москва и обл.	4116730	4275395	-158665	-3.71
416	-23	Аскольд	2480	Смоленская обл.	4077099	4380298	-303199	-6.92
417	46	Газстройбанк	2919	Москва и обл.	4031555	3061002	970553	31.71
418	-6	Новобанк	1352	Новгородская обл.	4026321	4009747	16574	0.41
419	122	Банк ИТБ	3128	Москва и обл.	4007485	2289426	1718059	75.04
420	-53	Енисейский Объединенный Банк	2645	Красноярский край	4003358	4780733	-777375	-16.26
421	-2	Межрегиональный промышленно-строительный банк	752	Мордовия	3997300	3896698	100602	2.58
422	49	Северный Кредит	2398	Вологодская обл.	3970313	3003118	967195	32.21
423	-24	Экси-Банк	2530	Санкт-Петербург и обл.	3966152	4338896	-372744	-8.59
424	2	Приоритет	3135	Самарская обл.	3898681	3755730	142951	3.81
425	96	Финансовый Капитал	3288	Санкт-Петербург и обл.	3874277	2497552	1376725	55.12
426	-29	Промрегионбанк	2123	Томская обл.	3839599	4344021	-504422	-11.61
427	52	Интернациональный Торговый Банк	2609	Омская обл.	3827309	2884866	942443	32.67
428	1	Нейва	1293	Свердловская обл.	3803657	3706103	97554	2.63
429	9	Донкомбанк	492	Ростовская обл.	3791068	3388901	402167	11.87
430	38	Стройлесбанк	2995	Тюменская обл.	3784803	3026797	758006	25.04
431	-55	Донинвест	1617	Ростовская обл.	3743519	4690558	-947039	-20.19
432	-12	Заречье	817	Татарстан	3742924	3893963	-151039	-3.88
433	-32	Стратегия	2801	Москва и обл.	3711763	4283899	-572136	-13.36
434	48	Нефтепромбанк	2156	Москва и обл.	3707177	2855136	852041	29.84
435	-349	Банк Сберегательно-кредитного сервиса	3224	Москва и обл.	3676332	51026676	-47350344	-92.8
436	135	Эл Банк	1025	Самарская обл.	3633027	1987218	1645809	82.82
437	-93	Сиббизнесбанк	2539	Тюменская обл.	3630058	5507737	-1877679	-34.09
438	-40	Новопокровский	467	Краснодарский край	3621039	4341374	-720335	-16.59
439	41	Кузнецкий	609	Пензенская обл.	3610836	2884096	726740	25.2
440	57	Азия-Инвест Банк	3303	Москва и обл.	3593673	2688085	905588	33.69
441	13	Мастер-Капитал	3011	Москва и обл.	3548278	3152149	396129	12.57
442	-3	Еврокоммерц	1777	Москва и обл.	3535889	3387383	148506	4.38
443	73	Витабанк	356	Санкт-Петербург и обл.	3517171	2541225	975946	38.4
444	-13	Тюменьагропромбанк	917	Тюменская обл.	3517067	3638548	-121481	-3.34
445	62	Милбанк	3256	Москва и обл.	3494595	2622215	872380	33.27
446	44	Универсальный Кредит	2903	Москва и обл.	3418301	2758839	659462	23.9
447	55	Невский Банк	1068	Санкт-Петербург и обл.	3400924	2636402	764522	29
448	30	Земский Банк	2900	Самарская обл.	3397073	2893887	503186	17.39
449	-4	Оргбанк	3312	Москва и обл.	3365474	3304785	60689	1.84
450	-8	Мосуралбанк	2468	Москва и обл.	3341676	3328532	13144	0.39
451	-5	РБА	3413	Ярославская обл.	3321122	3294338	26784	0.81
452	-5	Интерактивный Банк	3378	Москва и обл.	3313014	3243256	69758	2.15
453	22	Синко-Банк	2838	Москва и обл.	3301127	2921637	379490	12.99
454	23	Роял Кредит Банк	783	Хабаровский край	3286020	2904904	381116	13.12
455	0	Алтайкапиталбанк	2659	Алтайский край	3268917	3151158	117759	3.74
456	75	Форус Банк	3457	Нижегородская обл.	3233660	2397315	836345	34.89
457	106	Кроссинвестбанк	2849	Москва и обл.	3229313	2048336	1180977	57.66
458	-21	Евроальянс	1781	Ивановская обл.	3226762	3399318	-172556	-5.08
459	-119	Объединенная Расчетная Система	3342	Москва и обл.	3186198	5568235	-2382037	-42.78
460	80	Смартбанк	3408	Москва и обл.	3167202	2298292	868910	37.81
461	54	Сберинвестбанк	1743	Свердловская обл.	3152883	2545911	606972	23.84
462	49	ЕвроАксис Банк	3273	Москва и обл.	3127867	2576011	551856	21.42
463	81	Русский Трастовый Банк	1139	Москва и обл.	3118152	2220710	897442	40.41
464	-11	Горбанк	2982	Санкт-Петербург и обл.	3116004	3155573	-39569	-1.25
465	23	Сити Инвест Банк	3194	Санкт-Петербург и обл.	3100069	2788575	311494	11.17
466	-10	Камчаткомагропромбанк	545	Камчатская обл.	3080968	3150820	-69852	-2.22
467	16	Живаго-Банк	2065	Рязанская обл.	3073031	2852674	220357	7.72
468	74	Банк Экономический Союз	2798	Москва и обл.	3071743	2262714	809029	35.75
469	98	Сибирский Банк Реконструкции и Развития	1284	Тюменская обл.	3070193	2024167	1046026	51.68
470	-35	Наш Дом	3296	Москва и обл.	3065767	3449349	-383582	-11.12
471	57	Консервативный Коммерческий Банк	1087	Астраханская обл.	3053413	2425386	628027	25.89
472	-57	Бинбанк Сургут	1701	Тюменская обл.	3047367	3961587	-914220	-23.08
473	-40	Ураллига	1626	Челябинская обл.	3015938	3601722	-585784	-16.26
474	-4	Союзный	3236	Москва и обл.	3002800	3005691	-2891	-0.1
475	-31	Первый Инвестиционный банк	604	Москва и обл.	2974877	3306559	-331682	-10.03
476	16	Уральский Межрегиональный Банк	1441	Свердловская обл.	2955755	2724266	231489	8.5
477	-20	Москва-Сити	3247	Москва и обл.	2955667	3124831	-169164	-5.41
478	7	Гринфилдбанк	2711	Москва и обл.	2947982	2820523	127459	4.52
479	26	Венец	524	Ульяновская обл.	2934460	2626314	308146	11.73
480	11	Еврокредит	2957	Москва и обл.	2932419	2732177	200242	7.33
481	0	Долинск	857	Сахалинская обл.	2915386	2863265	52121	1.82
482	-33	Уралпромбанк	2964	Челябинская обл.	2911327	3232351	-321024	-9.93
483	-19	Региональный Кредитный Банк	1608	Калининградская обл.	2894422	3049389	-154967	-5.08
484	35	Тамбовкредитпромбанк	1312	Тамбовская обл.	2889231	2503758	385473	15.4
485	-12	Итуруп	2390	Сахалинская обл.	2886917	2952787	-65870	-2.23
486	-12	Система	2846	Москва и обл.	2858064	2937324	-79260	-2.7
487	52	Профессионал Банк	2471	Москва и обл.	2857524	2315644	541880	23.4
488	-4	Нокссбанк	3202	Волгоградская обл.	2836107	2826060	10047	0.36
489	47	Коммерческий Индо Банк	3446	Москва и обл.	2820557	2362807	457750	19.37
490	-31	ПК-Банк	2652	Москва и обл.	2819612	3098034	-278422	-8.99
491	-19	Преодоление	2649	Москва и обл.	2800732	2964341	-163609	-5.52
492	-56	Океан Банк	1697	Москва и обл.	2787512	3424204	-636692	-18.59
493	27	Банк РМП	2574	Москва и обл.	2785943	2503223	282720	11.29
494	41	Аксонбанк	680	Костромская обл.	2766178	2365073	401105	16.96
495	-87	Коммерческий Банк Развития	3364	Москва и обл.	2741135	4081922	-1340787	-32.85
496	107	Риал-Кредит	3393	Москва и обл.	2735335	1727467	1007868	58.34
497	-35	Крыловский	456	Краснодарский край	2735007	3064314	-329307	-10.75
498	-3	Енисей	474	Красноярский край	2709707	2694016	15691	0.58
499	9	Тульский Промышленник	2382	Тульская обл.	2706404	2588288	118116	4.56
500	26	Интеркапитал-Банк	2706	Мордовия	2697193	2455135	242058	9.86
501	9	Уссури	596	Хабаровский край	2693689	2578987	114702	4.45
502	-15	Уралприватбанк	153	Свердловская обл.	2657476	2794783	-137307	-4.91
503	178	Эргобанк	2856	Москва и обл.	2644656	1265520	1379136	108.98
504	-8	ИпоТек Банк	2794	Москва и обл.	2642731	2691037	-48306	-1.8
505	32	Московский Коммерческий Банк	3172	Москва и обл.	2640151	2347098	293053	12.49
506	28	Совинком	2302	Москва и обл.	2627473	2370865	256608	10.82
507	78	НБК-Банк	3283	Москва и обл.	2622057	1859288	762769	41.02
508	-43	Интеркредит	3047	Москва и обл.	2621907	3048394	-426487	-13.99
509	-11	Гагаринский	606	Москва и обл.	2607051	2667820	-60769	-2.28
510	22	Финансово-Промышленный Капитал	3295	Москва и обл.	2598490	2391681	206809	8.65
511	42	Евразийский Банк	969	Москва и обл.	2594912	2119757	475155	22.42
512	17	Костромаселькомбанк	1115	Костромская обл.	2584227	2399571	184656	7.7
513	-44	Капитал	575	Москва и обл.	2583567	3018811	-435244	-14.42
514	43	Богородский	1277	Нижегородская обл.	2564483	2107782	456701	21.67
515	-65	Инкаробанк	2696	Москва и обл.	2558776	3230551	-671775	-20.79
516	-49	Аспект	608	Москва и обл.	2558080	3033252	-475172	-15.67
517	-3	Агророс	2860	Саратовская обл.	2548664	2549615	-951	-0.04
518	-32	Траст Капитал Банк	2741	Москва и обл.	2513093	2816399	-303306	-10.77
519	6	Национальный Банк Сбережений	1949	Ивановская обл.	2507708	2462894	44814	1.82
520	3	Вкабанк	1027	Астраханская обл.	2507310	2476402	30908	1.25
521	1	Вологжанин	1896	Вологодская обл.	2507147	2488689	18458	0.74
522	-28	Росбизнесбанк	1405	Москва и обл.	2457122	2697890	-240768	-8.92
523	46	Мираф-Банк	2244	Омская обл.	2448387	2006411	441976	22.03
524	0	Витязь	2890	Москва и обл.	2434713	2464751	-30038	-1.22
525	-161	Крокус-Банк	2682	Москва и обл.	2411253	4869858	-2458605	-50.49
526	-66	Новое Время	3492	Москва и обл.	2408212	3081008	-672796	-21.84
527	29	Диг-Банк	2423	Северная Осетия — Алания	2402496	2109363	293133	13.9
528	135	Богородский Муниципальный Банк	2992	Москва и обл.	2376578	1374053	1002525	72.96
529	86	Церих	3278	Орловская обл.	2373274	1658128	715146	43.13
530	51	Владпромбанк	870	Владимирская обл.	2367785	1872453	495332	26.45
531	37	Объединенный Резервный Банк	937	Москва и обл.	2367042	2018328	348714	17.28
532	6	Констанс-Банк	2228	Санкт-Петербург и обл.	2337386	2332375	5011	0.21
533	49	Резерв	2364	Челябинская обл.	2313835	1868046	445789	23.86
534	90	Промсельхозбанк	538	Москва и обл.	2309751	1554361	755390	48.6
535	14	Финтрастбанк	3104	Москва и обл.	2295295	2183980	111315	5.1
536	-24	ИРС	272	Москва и обл.	2294301	2553222	-258921	-10.14
537	33	Пульс Столицы	3002	Москва и обл.	2278681	2002094	276587	13.81
538	22	ФорБанк	2063	Алтайский край	2275428	2079697	195731	9.41
539	25	Эсидбанк	1991	Дагестан	2274190	2047463	226727	11.07
540	-39	Бум-Банк	1137	Кабардино-Балкария	2273807	2639508	-365701	-13.85
541	10	Вэлтон Банк	1105	Белгородская обл.	2269467	2156903	112564	5.22
542	3	ИК Банк	1732	Татарстан	2227563	2202226	25337	1.15
543	40	Ваш Личный Банк	1222	Иркутская обл.	2218889	1864179	354710	19.03
544	131	Инбанк	1829	Москва и обл.	2201972	1298234	903738	69.61
545	299	Промышленно-Финансовое Сотрудничество	2410	Москва и обл.	2194631	510910	1683721	329.55
546	47	Компания Розничного Кредитования	3385	Москва и обл.	2176719	1787508	389211	21.77
547	12	МФБанк	3163	Москва и обл.	2175626	2096536	79090	3.77
548	-1	Братский АНКБ	1144	Иркутская обл.	2168545	2197572	-29027	-1.32
549	67	Спиритбанк	2053	Тульская обл.	2167986	1649352	518634	31.44
550	4	Элита	1399	Калужская обл.	2153872	2116233	37639	1.78
551	14	Дом-Банк	3209	Москва и обл.	2134805	2046901	87904	4.29
552	44	Йошкар-Ола	2802	Марий Эл	2124497	1755194	369303	21.04
553	37	КОР	2148	Волгоградская обл.	2117883	1800066	317817	17.66
554	12	РСКБ	2050	Москва и обл.	2092925	2025259	67666	3.34
555	49	Зираат Банк	2559	Москва и обл.	2092704	1724520	368184	21.35
556	-1	Пермь	875	Пермская обл.	2092016	2112681	-20665	-0.98
557	34	Приско Капитал Банк	2537	Москва и обл.	2070694	1796785	273909	15.24
558	-15	Юнистрим	3467	Москва и обл.	2050900	2260855	-209955	-9.29
559	14	Кросна-Банк	2607	Москва и обл.	2050549	1945070	105479	5.42
560	16	Стелла-Банк	2948	Ростовская обл.	2031338	1921400	109938	5.72
561	28	Радиотехбанк	1166	Нижегородская обл.	2016007	1808148	207859	11.5
562	-4	Мегаполис	3265	Чувашия	2015584	2106023	-90439	-4.29
563	-13	Яринтербанк	2564	Ярославская обл.	2012808	2168502	-155694	-7.18
564	-2	Современные Стандарты Бизнеса	3397	Москва и обл.	2011168	2048843	-37675	-1.84
565	72	Конфидэнс Банк	970	Костромская обл.	2006328	1496639	509689	34.06
566	34	Верхневолжский	1084	Ярославская обл.	2006178	1739729	266449	15.32
567	-49	Социум-Банк	2881	Москва и обл.	1994806	2516935	-522129	-20.74
568	242	Таурус Банк	655	Челябинская обл.	1991589	660662	1330927	201.45
569	8	Кубанский Универсальный Банк	2898	Краснодарский край	1986651	1920030	66621	3.47
570	8	Выборг-Банк	720	Санкт-Петербург и обл.	1981470	1917940	63530	3.31
571	119	Северо-Западный 1 Альянс Банк	766	Санкт-Петербург и обл.	1977995	1211041	766954	63.33
572	20	Иваново	1763	Ивановская обл.	1973798	1789645	184153	10.29
573	195	Инвестсоцбанк	3010	Москва и обл.	1973447	817994	1155453	141.25
574	45	Лайтбанк	3177	Москва и обл.	1971842	1614940	356902	22.1
575	92	Земкомбанк	574	Ростовская обл.	1967998	1363459	604539	44.34
576	-76	Союзпромбанк	2965	Москва и обл.	1961584	2644446	-682862	-25.82
577	36	Проинвестбанк	784	Пермская обл.	1954952	1667932	287020	17.21
578	-69	Тагилбанк	1635	Свердловская обл.	1952593	2579282	-626689	-24.3
579	1	Липецкий Областной Банк	1794	Липецкая обл.	1948460	1885124	63336	3.36
580	27	Михайловский ПЖСБ	2961	Волгоградская обл.	1948373	1701816	246557	14.49
581	-48	Новый Символ	370	Москва и обл.	1946937	2372767	-425830	-17.95
582	-157	Тендер-Банк	2252	Москва и обл.	1944140	3773736	-1829596	-48.48
583	26	Россита-Банк	3257	Москва и обл.	1943408	1693838	249570	14.73
584	27	Ринвестбанк	3262	Рязанская обл.	1938192	1688009	250183	14.82
585	12	Вестерн Юнион ДП Восток	2726	Москва и обл.	1923051	1747232	175819	10.06
586	146	Санкт-Петербургский Банк Инвестиций	3468	Санкт-Петербург и обл.	1917804	975475	942329	96.6
587	226	Европейский Индустриальный Банк	2503	Москва и обл.	1916400	636044	1280356	201.3
588	-13	Апабанк	2404	Москва и обл.	1905542	1927263	-21721	-1.13
589	-3	Старооскольский Агропромбанк	1050	Белгородская обл.	1888683	1823819	64864	3.56
590	122	Международный Расчетный Банк	3028	Москва и обл.	1886845	1097546	789299	71.91
591	163	Рублевский	2192	Москва и обл.	1881014	866981	1014033	116.96
592	-31	Донхлеббанк	2285	Ростовская обл.	1866891	2059283	-192392	-9.34
593	35	РТС-Банк	3401	Самарская обл.	1861949	1537697	324252	21.09
594	36	Арт-Банк	2779	Северная Осетия — Алания	1853307	1534629	318678	20.77
595	348	Межбанковский Кредитный Союз	3242	Москва и обл.	1843338	145017	1698321	1171.12
596	-22	Новация	840	Адыгея	1832799	1934244	-101445	-5.24
597	30	Эльбин	2267	Дагестан	1820415	1540105	280310	18.2
598	-11	Нальчик	695	Кабардино-Балкария	1793481	1820643	-27162	-1.49
599	-72	Российский Национальный Коммерческий Банк	1354	Москва и обл.	1788715	2433105	-644390	-26.48
600	-21	Газнефтьбанк	3223	Саратовская обл.	1774110	1914959	-140849	-7.36
601	20	Владбизнесбанк	903	Владимирская обл.	1770869	1611070	159799	9.92
602	31	Крона-Банк	2499	Иркутская обл.	1767472	1515266	252206	16.64
603	3	Новокиб	1747	Кемеровская обл.	1764485	1701986	62499	3.67
604	-10	Национальный Корпоративный Банк	3422	Москва и обл.	1762008	1762483	-475	-0.03
605	147	Айви Банк	2055	Москва и обл.	1757854	884623	873231	98.71
606	48	Торговый Городской Банк	3180	Тверская обл.	1749511	1409942	339569	24.08
607	13	Сервис-Резерв	2034	Москва и обл.	1740555	1614098	126457	7.83
608	4	Соколовский	2830	Москва и обл.	1732566	1686640	45926	2.72
609	27	Пурпе	709	Тюменская обл.	1732288	1508205	224083	14.86
610	4	Новый Промышленный Банк	930	Москва и обл.	1724943	1665517	59426	3.57
611	151	Идея Банк	430	Краснодарский край	1723591	837682	885909	105.76
612	-17	Торжокуниверсалбанк	933	Тверская обл.	1709826	1761201	-51375	-2.92
613	-137	Банк МБФИ	2073	Москва и обл.	1706044	2907222	-1201178	-41.32
614	-4	Викинг	2	Санкт-Петербург и обл.	1683975	1691442	-7467	-0.44
615	152	Леноблбанк	1003	Санкт-Петербург и обл.	1682833	818214	864619	105.67
616	13	Мострансбанк	2258	Москва и обл.	1682367	1535121	147246	9.59
617	96	Стройиндбанк	155	Москва и обл.	1681784	1094786	586998	53.62
618	58	БВА Банк	1684	Москва и обл.	1654852	1294430	360422	27.84
619	-17	Татагропромбанк	728	Татарстан	1641120	1733705	-92585	-5.34
620	24	Нарат	1902	Саратовская обл.	1616970	1471398	145572	9.89
621	10	Национальный Банк Взаимного Кредита	3214	Москва и обл.	1616586	1530707	85879	5.61
622	51	Бумеранг	1002	Вологодская обл.	1611305	1303009	308296	23.66
623	12	Единственный	3187	Москва и обл.	1607868	1508431	99437	6.59
624	99	Бест Эффортс Банк	435	Москва и обл.	1607485	1029333	578152	56.17
625	-24	РФИ Банк	3351	Москва и обл.	1606586	1736247	-129661	-7.47
626	29	Тандем	1951	Москва и обл.	1588726	1409144	179582	12.74
627	32	Столичный Кредит	2853	Москва и обл.	1550617	1402615	148002	10.55
628	19	Кредит Экспресс	3186	Ростовская обл.	1547545	1451856	95689	6.59
629	55	Московский Вексельный Банк	2697	Москва и обл.	1546650	1237791	308859	24.95
630	56	Вологдабанк	992	Вологодская обл.	1544328	1229981	314347	25.56
631	40	Национальный Республиканский Банк	3359	Москва и обл.	1521431	1327513	193918	14.61
632	28	БСТ-Банк	2883	Кемеровская обл.	1509947	1399399	110548	7.9
633	-1	Холмск	503	Сахалинская обл.	1509797	1525711	-15914	-1.04
634	-82	Сталь Банк	2248	Москва и обл.	1509577	2139759	-630182	-29.45
635	87	Далена	1948	Москва и обл.	1499134	1031622	467512	45.32
636	55	Тайм Банк	3120	Москва и обл.	1497795	1201861	295934	24.62
637	100	Алтынбанк	2070	Татарстан	1493748	956184	537564	56.22
638	-54	Новый Век	3417	Москва и обл.	1491695	1862839	-371144	-19.92
639	-13	Саратов	330	Саратовская обл.	1487967	1549093	-61126	-3.95
640	8	Приобье	537	Тюменская обл.	1481682	1448085	33597	2.32
641	-95	Контраст-Банк	2857	Москва и обл.	1481296	2201429	-720133	-32.71
642	74	Унифондбанк	3416	Москва и обл.	1468513	1089882	378631	34.74
643	23	Московско-Парижский Банк	2646	Москва и обл.	1465276	1366198	99078	7.25
644	-26	Интеркоопбанк	2803	Москва и обл.	1452967	1626465	-173498	-10.67
645	72	Канский	860	Красноярский край	1451919	1068651	383268	35.86
646	-147	Республиканский Кредитный Альянс	3017	Москва и обл.	1448317	2649681	-1201364	-45.34
647	-39	Великие Луки Банк	598	Псковская обл.	1443946	1698562	-254616	-14.99
648	-7	Европлан Банк	3052	Москва и обл.	1410860	1478209	-67349	-4.56
649	-44	Объединенный Банк Республики	1016	Чувашия	1404931	1706506	-301575	-17.67
650	27	Межрегиональный Клиринговый Банк	2543	Москва и обл.	1402942	1291886	111056	8.6
651	52	Академический Русский Банк	622	Москва и обл.	1398032	1133112	264920	23.38
652	-135	Кредитинвест	1197	Дагестан	1394089	2527338	-1133249	-44.84
653	-13	Новый Кредитный Союз	3139	Москва и обл.	1392748	1486789	-94041	-6.33
654	7	Кемсоцинбанк	96	Кемеровская обл.	1379863	1388188	-8325	-0.6
655	-4	Златкомбанк	568	Москва и обл.	1376339	1428748	-52409	-3.67
656	-33	Нерюнгрибанк	825	Саха (Якутия)	1370390	1559970	-189580	-12.15
657	108	Ганзакомбанк	1734	Санкт-Петербург и обл.	1351206	825815	525391	63.62
658	22	Народный Банк	2249	Карачаево-Черкесия	1341537	1269171	72366	5.7
659	59	Русский Национальный Банк	469	Ростовская обл.	1335580	1063108	272472	25.63
660	-22	Уралфинанс	1370	Свердловская обл.	1330489	1491685	-161196	-10.81
661	4	Руна-Банк	3207	Москва и обл.	1317738	1370479	-52741	-3.85
662	7	Гринкомбанк	1184	Иркутская обл.	1312397	1339042	-26645	-1.99
663	-272	Севзапинвестпромбанк	2152	Санкт-Петербург и обл.	1308156	4436014	-3127858	-70.51
664	-47	Финанс Бизнес Банк	520	Краснодарский край	1306077	1646519	-340442	-20.68
665	-16	Екатерининский	2167	Москва и обл.	1304268	1447539	-143271	-9.9
666	58	Смолевич	1121	Смоленская обл.	1304251	1022007	282244	27.62
667	1	Радиан	1675	Иркутская обл.	1295154	1341405	-46251	-3.45
668	-18	Флора-Москва	533	Москва и обл.	1292020	1437259	-145239	-10.11
669	9	Максима	3379	Москва и обл.	1291231	1284140	7091	0.55
670	56	Банкирский Дом	2928	Санкт-Петербург и обл.	1277799	1007032	270767	26.89
671	136	Инвестиционный Республиканский Банк	2571	Москва и обл.	1275370	674612	600758	89.05
672	-20	Спутник	1071	Оренбургская обл.	1259173	1426255	-167082	-11.71
673	-31	Геленджик-Банк	790	Краснодарский край	1243187	1474781	-231594	-15.7
674	-21	Примтеркомбанк	21	Приморский край	1243023	1416036	-173013	-12.22
675	-18	Азимут	3154	Москва и обл.	1240461	1402825	-162364	-11.57
676	20	Содружество	2923	Москва и обл.	1236196	1174581	61615	5.25
677	21	Бизнес для Бизнеса	1060	Чувашия	1234631	1165768	68863	5.91
678	23	Калуга	1151	Калужская обл.	1228430	1146250	82180	7.17
679	0	Жилкредит	1736	Москва и обл.	1228065	1273626	-45561	-3.58
680	19	Майкопбанк	1136	Адыгея	1227522	1160783	66739	5.75
681	8	Сибэс	208	Омская обл.	1226289	1213150	13139	1.08
682	3	Идеалбанк	3491	Москва и обл.	1213039	1236710	-23671	-1.91
683	-58	Саммит Банк	85	Приморский край	1191373	1551300	-359927	-23.2
684	61	ИстКом-Финанс	3435	Москва и обл.	1190674	917663	273011	29.75
685	-27	Приполярком	507	Тюменская обл.	1188491	1402672	-214181	-15.27
686	34	Булгар Банк	1917	Татарстан	1188237	1041094	147143	14.13
687	62	Глобус	2438	Москва и обл.	1186515	897933	288582	32.14
688	33	Си Ди Би Банк	3339	Краснодарский край	1171733	1038798	132935	12.8
689	120	Газтрансбанк	665	Адыгея	1168886	666024	502862	75.5
690	-177	Мосводоканалбанк	2863	Москва и обл.	1166981	2552817	-1385836	-54.29
691	2	Онего	2484	Карелия	1152804	1193322	-40518	-3.4
692	36	Кетовский Коммерческий Банк	842	Курганская обл.	1148513	1006035	142478	14.16
693	-29	Кредитимпэкс Банк	2037	Москва и обл.	1147784	1373291	-225507	-16.42
694	15	Метрополь	1639	Москва и обл.	1145668	1112485	33183	2.98
695	-21	Русский Элитарный Банк	3231	Москва и обл.	1139789	1299989	-160200	-12.32
696	-193	Банк Премьер Кредит	1663	Коми	1135168	2636278	-1501110	-56.94
697	30	Симбирск	653	Ульяновская обл.	1134714	1007012	127702	12.68
698	45	Ноосфера	2650	Республика Алтай	1130719	919224	211495	23.01
699	-5	Синергия	2884	Саратовская обл.	1128990	1193311	-64321	-5.39
700	134	Заубер Банк	1614	Карачаево-Черкесия	1128225	523151	605074	115.66
701	-1	Дон-Тексбанк	1818	Ростовская обл.	1126522	1156207	-29685	-2.57
702	27	Народный Доверительный Банк	2374	Москва и обл.	1125220	1004392	120828	12.03
703	52	Мурманский Расчетный Центр	3341	Мурманская обл.	1109523	858962	250561	29.17
704	-65	КИП-Банк	2843	Москва и обл.	1100663	1490587	-389924	-26.16
705	65	Расчетный Дом	3350	Москва и обл.	1096103	804871	291232	36.18
706	-1	Восточно-Европейский Трастовый Банк	2253	Москва и обл.	1093595	1122992	-29397	-2.62
707	80	Тексбанк	2756	Карачаево-Черкесия	1088694	745422	343272	46.05
708	-1	Северинвестбанк	2264	Белгородская обл.	1086106	1119074	-32968	-2.95
709	-47	Рапида	3371	Москва и обл.	1073509	1380179	-306670	-22.22
710	5	Региональный Банк Сбережений	3367	Москва и обл.	1071137	1090996	-19859	-1.82
711	89	Динамичные Системы	3439	Москва и обл.	1069612	697771	371841	53.29
712	-66	Металлург	2877	Москва и обл.	1069340	1464377	-395037	-26.98
713	-2	Атлас Банк	3477	Москва и обл.	1061290	1100022	-38732	-3.52
714	-166	Арксбанк	1868	Воронежская обл.	1059435	2186591	-1127156	-51.55
715	133	Капиталбанк	2547	Ростовская обл.	1056936	491528	565408	115.03
716	3	Сельмашбанк	106	Ростовская обл.	1054065	1058086	-4021	-0.38
717	13	Первый Дортрансбанк	3271	Кировская обл.	1053768	988339	65429	6.62
718	-10	Акрополь	3027	Москва и обл.	1048250	1113357	-65107	-5.85
719	-49	Регионфинансбанк	3357	Москва и обл.	1047922	1331798	-283876	-21.32
720	-38	Байкалкредобанк	2990	Иркутская обл.	1043216	1263659	-220443	-17.44
721	36	Почтобанк	1788	Пермская обл.	1038191	849523	188668	22.21
722	28	Первоуральскбанк	965	Свердловская обл.	1037122	892527	144595	16.2
723	-9	Америкэн Экспресс Банк	3460	Москва и обл.	1032010	1094670	-62660	-5.72
724	37	Курган	2568	Курганская обл.	1023745	842455	181290	21.52
725	112	Миръ	3089	Москва и обл.	1023533	518754	504779	97.31
726	-128	Центрально-Азиатский	3037	Хакасия	1009331	1745267	-735936	-42.17
727	21	ЕАТП Банк	1765	Астраханская обл.	1001388	910462	90926	9.99
728	44	Первый Клиентский Банк	3436	Москва и обл.	982886	800311	182575	22.81
729	-86	ВЕБРР	3418	Москва и обл.	971612	1474327	-502715	-34.1
730	167	Трансинвестбанк	3238	Москва и обл.	967909	338094	629815	186.28
731	61	Акцент	696	Оренбургская обл.	967129	732638	234491	32.01
732	34	МС Банк Рус	2789	Москва и обл.	960221	821272	138949	16.92
733	-46	Анелик РУ	3443	Москва и обл.	954199	1228410	-274211	-22.32
734	-3	Турбобанк	3203	Санкт-Петербург и обл.	946920	985968	-39048	-3.96
735	0	Мурманский Социальный Коммерческий Банк	2722	Мурманская обл.	939544	970309	-30765	-3.17
736	33	Арзамас	1281	Нижегородская обл.	921166	812225	108941	13.41
737	-33	Трастовый Республиканский Банк	3404	Москва и обл.	919237	1128409	-209172	-18.54
738	-2	Местный Кредит	3370	Москва и обл.	917043	958248	-41205	-4.3
739	0	Аскания Траст	286	Москва и обл.	915155	933576	-18421	-1.97
740	37	Месед	184	Дагестан	909877	779927	129950	16.66
741	0	Химик	1114	Нижегородская обл.	904574	927531	-22957	-2.48
742	124	Индустриальный Сберегательный Банк	3175	Москва и обл.	902448	452399	450049	99.48
743	109	Нафтабанк	715	Дагестан	892147	478143	414004	86.59
744	-34	РН Банк	170	Омская обл.	888773	1106180	-217407	-19.65
745	18	Прайм Финанс	2758	Санкт-Петербург и обл.	886728	837648	49080	5.86
746	-21	Финарс Банк	2938	Москва и обл.	885042	1020195	-135153	-13.25
747	11	Тетраполис	1586	Санкт-Петербург и обл.	882174	847479	34695	4.09
748	-10	ОЛМА-Банк	3250	Москва и обл.	880788	946771	-65983	-6.97
749	15	Вакобанк	1291	Псковская обл.	878330	835449	42881	5.13
750	43	Региональный Коммерческий Банк	836	Ульяновская обл.	875919	729036	146883	20.15
751	40	Кредитбанк	1035	Калмыкия	868951	737233	131718	17.87
752	-1	Евроазиатский Инвестиционный Банк	2897	Москва и обл.	866906	888204	-21298	-2.4
753	48	Жилстройбанк	2769	Москва и обл.	866764	695242	171522	24.67
754	48	Русский Банк Сбережений	779	Ставропольский край	860993	693256	167737	24.2
755	-22	Сургутский Центральный Коммерческий Банк	684	Тюменская обл.	849802	973409	-123607	-12.7
756	0	Бузулукбанк	1282	Оренбургская обл.	848183	850792	-2609	-0.31
757	41	Взаимодействие	1704	Новосибирская обл.	847480	708329	139151	19.64
758	45	Мико-Банк	3195	Москва и обл.	839935	693104	146831	21.18
759	-67	Межрегионбанк	1059	Москва и обл.	839730	1193594	-353864	-29.65
760	11	Спецстройбанк	236	Москва и обл.	836631	801551	35080	4.38
761	-27	Тульский Расчетный Центр	3380	Тульская обл.	835925	972026	-136101	-14
762	20	Лето Банк	650	Москва и обл.	834801	766446	68355	8.92
763	-3	РусьРегионБанк	685	Москва и обл.	798925	843757	-44832	-5.31
764	-24	Инвест-Экобанк	1956	Санкт-Петербург и обл.	785453	929249	-143796	-15.47
765	-82	Адам Интернэшнл	2232	Дагестан	780869	1238273	-457404	-36.94
766	-121	Космос	2245	Москва и обл.	780624	1469592	-688968	-46.88
767	-21	Аделантбанк	1835	Москва и обл.	775203	916870	-141667	-15.45
768	6	Балаково-Банк	444	Саратовская обл.	771017	784729	-13712	-1.75
769	6	Кузбассхимбанк	2868	Кемеровская обл.	768671	784256	-15585	-1.99
770	35	Народный Земельно-Промышленный Банк	2873	Алтайский край	766544	681318	85226	12.51
771	-18	Башпромбанк	1006	Башкортостан	759964	877587	-117623	-13.4
772	-13	МТИ-Банк	1052	Москва и обл.	756522	846094	-89572	-10.59
773	21	Прокоммерцбанк	2996	Москва и обл.	752397	724820	27577	3.8
774	47	Стандарт-Кредит	841	Адыгея	745163	589770	155393	26.35
775	105	Камский Горизонт	2554	Татарстан	741736	402744	338992	84.17
776	-373	Лада-Кредит	2668	Самарская обл.	739930	4225508	-3485578	-82.49
777	7	Классик Эконом Банк	3298	Северная Осетия — Алания	738601	752323	-13722	-1.82
778	34	Прохладный	874	Кабардино-Балкария	738029	648141	89888	13.87
779	37	Плато-Банк	2071	Свердловская обл.	736350	620728	115622	18.63
780	70	Международный Строительный Банк	3484	Москва и обл.	730038	487139	242899	49.86
781	27	Агроинкомбанк	1946	Астраханская обл.	723598	671549	52049	7.75
782	-3	Арсенал	3000	Москва и обл.	721453	777351	-55898	-7.19
783	16	НоваховКапиталБанк	635	Москва и обл.	707885	703308	4577	0.65
784	31	Акция	927	Ивановская обл.	706061	626913	79148	12.63
785	19	Славянбанк	804	Новгородская обл.	702636	692781	9855	1.42
786	33	НСТ-Банк	1738	Оренбургская обл.	702202	602005	100197	16.64
787	10	Кутузовский	3190	Москва и обл.	696684	708603	-11919	-1.68
788	124	Азия Банк	3183	Москва и обл.	695132	274528	420604	153.21
789	-11	Геобанк	2027	Москва и обл.	693274	779522	-86248	-11.06
790	50	Вятич	2796	Рязанская обл.	681512	515941	165571	32.09
791	70	ЮМК	3495	Краснодарский край	678763	463563	215200	46.42
792	4	Московский Национальный Инвестиционный Банк	3181	Москва и обл.	673721	711963	-38242	-5.37
793	38	Платежный Сервисный Банк	1943	Башкортостан	655817	532729	123088	23.11
794	52	Эко-Инвест	3116	Москва и обл.	651852	495490	156362	31.56
795	0	Кубаньторгбанк	478	Краснодарский край	650570	717461	-66891	-9.32
796	33	Банк Развития Бизнеса	1910	Кемеровская обл.	647235	540049	107186	19.85
797	82	Строительно-Коммерческий Банк	3050	Архангельская обл.	647024	413415	233609	56.51
798	38	Ипозембанк	3026	Самарская обл.	647022	520936	126086	24.2
799	102	Региональный Корпоративный Банк	1134	Ивановская обл.	645440	323087	322353	99.77
800	-10	Одинбанк	3197	Москва и обл.	639725	737466	-97741	-13.25
801	27	Анджибанк	570	Дагестан	638384	567093	71291	12.57
802	31	Рингкомбанк	1909	Ингушетия	637452	529481	107971	20.39
803	-20	Центр Межбанковских Расчетов	3400	Москва и обл.	633232	761110	-127878	-16.8
804	-15	Каспий	639	Дагестан	632844	743764	-110920	-14.91
805	12	Старый Кремль	2657	Москва и обл.	609503	612902	-3399	-0.55
806	-26	Дагестан	543	Дагестан	592808	771111	-178303	-23.12
807	11	Линк-Банк	2699	Москва и обл.	591083	604723	-13640	-2.26
808	59	Майский	1673	Кабардино-Балкария	590090	449755	140335	31.2
809	-67	Ресурс-Траст	3122	Москва и обл.	589248	923771	-334523	-36.21
810	16	Банк ВВБ	1093	Ярославская обл.	584644	576389	8255	1.43
811	-35	Московский Клиринговый Центр	3314	Москва и обл.	575829	782337	-206508	-26.4
812	-190	Межотраслевая Банковская Корпорация	3471	Москва и обл.	569150	1590778	-1021628	-64.22
813	52	Внешфинбанк	3173	Краснодарский край	552131	455230	96901	21.29
814	11	Европейский Экспресс	3449	Москва и обл.	550953	582698	-31745	-5.45
815	-118	ЭнергоБизнес	3485	Москва и обл.	549243	1173897	-624654	-53.21
816	33	Еврокапитал-Альянс	2672	Дагестан	545111	487245	57866	11.88
817	-6	Центрально-Европейский Банк	2670	Москва и обл.	543000	658898	-115898	-17.59
818	59	Конгресс-Банк	2330	Москва и обл.	541680	420722	120958	28.75
819	-313	Далетбанк	3049	Москва и обл.	538257	2623654	-2085397	-79.48
820	18	АББ	2937	Москва и обл.	532651	517765	14886	2.88
821	41	Объединенный Национальный Банк	2074	Москва и обл.	527346	461780	65566	14.2
822	41	Имбанк	2098	Дагестан	526383	458255	68128	14.87
823	45	Тальменка-Банк	826	Алтайский край	524059	443650	80409	18.12
824	15	Алданзолотобанк	854	Саха (Якутия)	514485	516447	-1962	-0.38
825	-3	РУБанк	2813	Ростовская обл.	511895	589577	-77682	-13.18
826	43	Холдинвестбанк	2837	Москва и обл.	506677	442119	64558	14.6
827	-4	Стар Альянс	3433	Москва и обл.	496212	584413	-88201	-15.09
828	4	Северная Клиринговая Палата	3317	Архангельская обл.	495189	530949	-35760	-6.74
829	24	Надежность	2425	Курганская обл.	491332	478062	13270	2.78
830	-16	Ауэрбанк	3105	Москва и обл.	486028	628913	-142885	-22.72
831	-25	ВРБ Москва	3499	Москва и обл.	484746	677942	-193196	-28.5
832	38	Дружба	990	Тюменская обл.	482728	441272	41456	9.39
833	-52	Москва	1661	Москва и обл.	481100	769219	-288119	-37.46
834	40	Гефест	1046	Тверская обл.	476929	430960	45969	10.67
835	-88	Ростфинанс	481	Ростовская обл.	476144	914306	-438162	-47.92
836	59	МВС Банк	2407	Дагестан	474794	344140	130654	37.97
837	17	Евросиб Банк	594	Псковская обл.	472002	477240	-5238	-1.1
838	26	НКБ	2942	Калмыкия	470118	456332	13786	3.02
839	-54	Природа	3399	Москва и обл.	468996	752251	-283255	-37.65
840	3	Иронбанк	1724	Москва и обл.	468867	511471	-42604	-8.33
841	-53	Вестинтербанк	3398	Москва и обл.	466857	744709	-277852	-37.31
842	43	Европейский Стандарт	3200	Кабардино-Балкария	466509	381918	84591	22.15
843	15	Принтбанк	546	Москва и обл.	463762	471133	-7371	-1.56
844	34	Кредпромбанк	1165	Ярославская обл.	463056	418123	44933	10.75
845	-72	Сунжа	2023	Ингушетия	462491	784891	-322400	-41.08
846	13	АлтайБизнес-Банк	2388	Алтайский край	461801	468036	-6235	-1.33
847	-6	Банк РСИ	3415	Москва и обл.	457447	513264	-55817	-10.87
848	12	Махачкалинский Городской Муниципальный Банк	3192	Дагестан	454309	466327	-12018	-2.58
849	7	Сетевая Расчетная Палата	3332	Татарстан	449065	474258	-25193	-5.31
850	-5	Далта-Банк	142	Приморский край	446595	510053	-63458	-12.44
851	80	Бизнесбанк	2862	Дагестан	441309	213543	227766	106.66
852		Еврокапитал-Альянс	3459	Ярославская обл.	435641			
853	34	Максимум	466	Ростовская обл.	434532	375675	58857	15.67
854	44	Басманный	2158	Москва и обл.	433084	329464	103620	31.45
855	-35	Промсвязьинвест	2761	Дагестан	430516	598459	-167943	-28.06
856	16	Русский Финансовый Альянс	2035	Москва и обл.	429417	433325	-3908	-0.9
857	31	РИТЦ Банк	2677	Москва и обл.	425412	374194	51218	13.69
858	35	Южный Региональный Банк	3015	Ростовская обл.	420797	354274	66523	18.78
859	57	ТЭСТ	3440	Москва и обл.	411265	260560	150705	57.84
860	40	Невастройинвест	1926	Санкт-Петербург и обл.	404363	324456	79907	24.63
861	-37	Новый Коммерческий Банк	347	Дагестан	397434	583539	-186105	-31.89
862	13	Российская Финансовая Корпорация	3099	Москва и обл.	395892	427991	-32099	-7.5
863	-21	Энтузиастбанк	3048	Москва и обл.	388487	512007	-123520	-24.12
864	42	1Банк	2896	Северная Осетия — Алания	388483	292779	95704	32.69
865	31	ПрестижКредитБанк	2922	Дагестан	388287	340284	48003	14.11
866	7	Кредо Финанс	793	Дагестан	386316	432009	-45693	-10.58
867	48	ГРиС-Банк	1928	Ставропольский край	373140	264582	108558	41.03
868	-11	Народный Инвестиционный Банк	2876	Самарская обл.	371887	473211	-101324	-21.41
869	40	Межрегиональный Банк Реконструкции	2620	Москва и обл.	371799	288023	83776	29.09
870	49	Народный Банк Республики Тыва	1309	Тыва	370388	242648	127740	52.64
871	21	Соверен Банк	3206	Москва и обл.	370138	358857	11281	3.14
872	-37	КБЦ	914	Тверская обл.	367258	522005	-154747	-29.64
873	61	Алжан	2491	Дагестан	361506	201501	160005	79.41
874	12	Таганрогбанк	3136	Ростовская обл.	360530	377832	-17302	-4.58
875	33	Альтернатива	3452	Москва и обл.	341492	291713	49779	17.06
876	31	Рента-Банк	3095	Москва и обл.	340502	292210	48292	16.53
877	-1	K2 Банк	2851	Дагестан	339353	424918	-85565	-20.14
878	4	АвтоКредитБанк	1973	Татарстан	338694	390089	-51395	-13.18
879	-49	Лидер	3304	Москва и обл.	330845	532764	-201919	-37.9
881	21	Континенталь	3184	Ставропольский край	321100	321376	-276	-0.09
882	-1	Регнум	3373	Москва и обл.	320339	396778	-76439	-19.26
883		Джаст Банк	3503	Москва и обл.	316759			
884	6	Эно	1988	Дагестан	316221	368554	-52333	-14.2
885	25	Дорис Банк	1679	Москва и обл.	313049	280448	32601	11.62
886	13	Логос	3233	Москва и обл.	308457	324889	-16432	-5.06
887	-16	Информпрогресс	2166	Москва и обл.	291929	440466	-148537	-33.72
888	35	Тайдон	2085	Кемеровская обл.	285893	234103	51790	22.12
889	16	Терра	3476	Москва и обл.	285052	300557	-15505	-5.16
890	21	Онлайн Банк	2462	Москва и обл.	278860	279422	-562	-0.2
891	12	Континент Финанс	149	Калужская обл.	276314	309163	-32849	-10.63
892	21	Кошелев-Банк	3300	Нижегородская обл.	268886	273592	-4706	-1.72
893	54	Уральская Расчетная Палата	3326	Москва и обл.	256053	86255	169798	196.86
894		Берейт	3505	Санкт-Петербург и обл.	250282			
895	37	Русское Финансовое Общество	3427	Москва и обл.	249676	205784	43892	21.33
896	26	Воронеж	654	Воронежская обл.	248512	234542	13970	5.96
897	-8	Трастовый Банк	2780	Дагестан	246400	370513	-124113	-33.5
898	28	Майма	1037	Республика Алтай	244984	227684	17300	7.6
899	19	Лэнд-Банк	1478	Москва и обл.	242274	242824	-550	-0.23
900	21	Инстройбанк	2743	Москва и обл.	234061	240137	-6076	-2.53
901	28	ФФИН Банк (бывш. Охабанк)	1143	Сахалинская обл.	230891	222238	8653	3.89
902	-18	Мигом	3323	Москва и обл.	229912	382180	-152268	-39.84
903	-52	Бринкс	3486	Москва и обл.	228285	480472	-252187	-52.49
904	16	Банковские Информационные Технологии	3318	Тульская обл.	224521	241140	-16619	-6.89
905	20	Первый Депозитный Банк	1244	Тверская обл.	222277	230221	-7944	-3.45
906	31	КредитАльянс	3472	Вологодская обл.	221024	191341	29683	15.51
907	-3	Фреско Банк	1415	Ярославская обл.	220014	302008	-81994	-27.15
908	22	Рунэтбанк	2829	Москва и обл.	215550	218616	-3066	-1.4
909		Единый Строительный Банк	3506	Москва и обл.	201582			
910	-83	Расчетная Палата СВМБ	3324	Самарская обл.	195670	573496	-377826	-65.88
911	45	Межрегиональный Клиринговый Центр	3424	Москва и обл.	183947	19993	163954	820.06
912	21	Красноярский Краевой Расчетный Центр	3483	Красноярский край	176528	202000	-25472	-12.61
913	31	Фидбэк	3502	Воронежская обл.	164075	132171	31904	24.14
914	10	Петербургский Расчетный Центр	3306	Санкт-Петербург и обл.	148681	232927	-84246	-36.17
915	42	Инновационный Расчетный Центр	3447	Москва и обл.	146864	19719	127145	644.78
916	20	Умут	2435	Дагестан	145672	199516	-53844	-26.99
917	25	Финансовые Услуги	3496	Москва и обл.	129623	148347	-18724	-12.62
918	22	Евроинвест	3383	Москва и обл.	126960	150353	-23393	-15.56
919	26	Расчетный Банковский Центр	3487	Москва и обл.	120727	127519	-6792	-5.33
920	18	Интеррасчет	1618	Карачаево-Черкесия	114710	175662	-60952	-34.7
921	20	Зеленокумская	1239	Ставропольский край	114207	148786	-34579	-23.24
922	26	Сергиево-Посадская Расчетная Палата	384	Москва и обл.	99983	84948	15035	17.7
923	16	Платежный Клиринговый Дом	3343	Москва и обл.	95653	158584	-62931	-39.68
924	37	Национальная Расчетная Компания	3386	Москва и обл.	90047	7686	82361	1071.57
925	3	Паритет	1860	Москва и обл.	80875	226827	-145952	-64.35
926	20	Вест	2605	Москва и обл.	77329	113961	-36632	-32.14
927	22	РИБ	2749	Москва и обл.	72995	67227	5768	8.58
928	36	Международная Уральская Расчетная Палата	3322	Москва и обл.	72450	2305	70145	3043.17
929	21	Сулак	749	Дагестан	70484	54322	16162	29.75
930	-3	Межрегиональный центр микрокредитования	3489	Воронежская обл.	69519	227455	-157936	-69.44
931	20	Транзит	2688	Дагестан	43730	52738	-9008	-17.08
932	22	Первый Земельный Расчетный Центр	3381	Курская обл.	34209	27175	7034	25.88
933	26	Сибирский Расчетный Центр	3308	Новосибирская обл.	24339	16771	7568	45.13
934	21	Тор Кредит	3497	Москва и обл.	23971	23887	84	0.35
935	18	Частный Расчетно-Кассовый Центр	3420	Москва и обл.	21016	38356	-17340	-45.21
936	22	Депозитный Кредитный Дом	3474	Москва и обл.	19148	17961	1187	6.61
937	28	Финансово-Расчетный Центр	3319	Астраханская обл.	6117	1887	4230	224.17
938		Ассигнация	865	Ставропольский край	5545			
939	23	Клиринговый Дом	3430	Санкт-Петербург и обл.	4120	3980	140	3.52
940	23	АРБ-Инкасс	3353	Москва и обл.	2945	2833	112	3.95
