Позиция в рейтинге	Изменение позиции в рейтинге	Название банка	Номер лицензии	Регион регистрации	Декабрь, 2015, тыс. рублей	Январь, 2013, тыс. рублей	Изменение, тыс. рублей	Изменение, %
1	0	Сбербанк России	1481	Москва и обл.	22433146804	14082252862	8350893942	59.3
2	0	ВТБ	1000	Санкт-Петербург и обл.	8742464567	4338506970	4403957597	101.51
3	0	Газпромбанк	354	Москва и обл.	4984239100	2814389584	2169849516	77.1
4	2	ВТБ 24	1623	Москва и обл.	2873642255	1511500758	1362141497	90.12
5	6	ФК Открытие	2209	Москва и обл.	2813360795	658177268	2155183527	327.45
6	-2	Россельхозбанк	3349	Москва и обл.	2551779006	1672771138	879007868	52.55
7	0	Альфа-Банк	1326	Москва и обл.	2166341765	1377045587	789296178	57.32
8	-3	Банк Москвы	2748	Москва и обл.	1753618069	1520101934	233516135	15.36
9	23	Национальный Клиринговый Центр	3466	Москва и обл.	1397028289	211699749	1185328540	559.91
10	-2	ЮниКредит Банк	1	Москва и обл.	1320713756	886111726	434602030	49.05
11	-2	Промсвязьбанк	3251	Москва и обл.	1221401758	703512015	517889743	73.61
12	8	Московский Кредитный Банк	1978	Москва и обл.	1113736506	320218464	793518042	247.81
13	-3	Росбанк	2272	Москва и обл.	885949682	694965066	190984616	27.48
14	-2	Райффайзенбанк	3292	Москва и обл.	874085221	636129628	237955593	37.41
15	23	Бинбанк	2562	Москва и обл.	756341388	164032856	592308532	361.09
16	5	Россия	328	Санкт-Петербург и обл.	558480227	320073599	238406628	74.48
17	-2	Банк «Санкт-Петербург»	436	Санкт-Петербург и обл.	549187807	377459109	171728698	45.5
18	5	Ханты-Мансийский банк Открытие	1971	Москва и обл.	511498142	298476987	213021155	71.37
19	40	Совкомбанк	963	Костромская обл.	491838800	97772413	394066387	403.04
20	-3	Ак Барс	2590	Татарстан	488877251	342762257	146114994	42.63
21	77	Московский Областной Банк	1751	Москва и обл.	464808093	44006519	420801574	956.23
22	0	Русский Стандарт	2289	Москва и обл.	460563326	301700094	158863232	52.66
23	-4	Ситибанк	2557	Москва и обл.	419809025	326162434	93646591	28.71
24	6	ИНГ Банк	2495	Москва и обл.	402937298	221820082	181117216	81.65
25	156	Рост Банк	2888	Москва и обл.	383248497	18296499	364951998	1994.65
26	-2	Связь-Банк	1470	Москва и обл.	369750955	269560402	100190553	37.17
27	-2	Нордеа Банк	3016	Москва и обл.	369124223	265476257	103647966	39.04
28	6	Национальный Банк «Траст»	3279	Москва и обл.	347406759	183375283	164031476	89.45
29	12	Уральский Банк Реконструкции и Развития	429	Свердловская обл.	346364159	147422942	198941217	134.95
30	-14	МДМ Банк	323	Москва и обл.	341635505	369245138	-27609633	-7.48
31	9	СМП Банк	3368	Москва и обл.	339534034	147603845	191930189	130.03
32	240	Югра	880	Ханты-Мансийский АО — Югра	327614178	9692523	317921655	3280.07
33	-7	Глобэкс	1942	Москва и обл.	284040902	236339119	47701783	20.18
34	-5	Зенит	3255	Москва и обл.	276777867	226905452	49872415	21.98
35	41	Всероссийский Банк Развития Регионов	3287	Москва и обл.	276530892	74287442	202243450	272.24
36	7	Новикомбанк	2546	Москва и обл.	275293911	130481520	144812391	110.98
37	9	Внешпромбанк	3261	Москва и обл.	274902436	117442614	157459822	134.07
38	-20	Хоум Кредит Банк	316	Москва и обл.	266352218	331652350	-65300132	-19.69
39	12	Абсолют Банк	2306	Москва и обл.	263012461	110483276	152529185	138.06
40	-13	Восточный Экспресс Банк	1460	Амурская обл.	226081496	233182612	-7101116	-3.05
41	3	Транскапиталбанк (ТКБ)	2210	Москва и обл.	223926661	122646212	101280449	82.58
42	-7	Московский Индустриальный Банк	912	Москва и обл.	219298948	172675164	46623784	0.27
43	-12	Возрождение	1439	Москва и обл.	217271750	221393243	-4121493	-1.86
44	14	Российский Капитал	2312	Москва и обл.	216520126	100318559	116201567	115.83
45	8	Татфондбанк	3058	Татарстан	201896350	108152554	93743796	86.68
46	22	Пересвет	2110	Москва и обл.	173689535	84625399	89064136	105.25
47	-8	ОТП Банк	2766	Москва и обл.	170545308	158934553	11610755	7.31
48	-11	МТС Банк	2268	Москва и обл.	165189870	168131059	-2941189	-1.75
49	-4	Кредит Европа Банк	3311	Москва и обл.	160362358	120512039	39850319	33.07
50	-3	РосЕвроБанк	3137	Москва и обл.	157642303	116715944	40926359	35.06
51	20	ДельтаКредит	3338	Москва и обл.	154603293	80169491	74433802	92.85
52	-3	Национальный Расчетный Депозитарий	3294	Москва и обл.	152226739	112653228	39573511	35.13
53	-5	МСП Банк	3340	Москва и обл.	151174289	115891829	35282460	30.44
54	7	Азиатско-Тихоокеанский Банк	1810	Амурская обл.	149712338	91033983	58678355	64.46
55	19	Тинькофф Банк	2673	Москва и обл.	147558418	75414961	72143457	95.66
56	9	Ренессанс Кредит	3354	Москва и обл.	146452707	89492688	56960019	63.65
57	-1	Росгосстрах Банк	3073	Москва и обл.	139433405	103668352	35765053	34.5
58	-6	Авангард	2879	Москва и обл.	138309498	110130208	28179290	25.59
59	40	Экспресс-Волга	3085	Саратовская обл.	127934576	43477455	84457121	194.25
60	34	Сургутнефтегазбанк	588	Ханты-Мансийский АО — Югра	124621375	50524562	74096813	146.66
61	-11	Инвестторгбанк	2763	Москва и обл.	124351866	111382988	12968878	11.64
62	-20	СКБ-Банк	705	Свердловская обл.	123055317	135371008	-12315691	-9.1
63	25	Международный Финансовый Клуб	2618	Москва и обл.	109054367	53092901	55961466	105.4
64	-9	Русфинанс Банк	1792	Самарская обл.	107382590	107935177	-552587	-0.51
65	14	ЦентроКредит	121	Москва и обл.	105749132	72157363	33591769	46.55
66	68	Сетелем Банк	2168	Москва и обл.	102941708	27408447	75533261	275.58
67	-1	Запсибкомбанк	918	Тюменская обл.	101284015	87519776	13764239	15.73
68	27	Интеркоммерц Банк	1657	Москва и обл.	101183817	47517935	53665882	112.94
69	-5	БНП Париба Банк	3407	Москва и обл.	101157539	89537170	11620369	12.98
70	21	Креди Агриколь КИБ	1680	Санкт-Петербург и обл.	99069353	51263618	47805735	93.25
71	-4	Балтийский Банк	128	Санкт-Петербург и обл.	97386906	84821302	12565604	14.81
72	0	Союз	2307	Москва и обл.	92553232	79129303	13423929	16.96
73	5	Локо-Банк	2707	Москва и обл.	92227894	72555717	19672177	27.11
74	12	Банк БФА	3038	Санкт-Петербург и обл.	89467395	56183522	33283873	59.24
75	6	Центр-инвест	2225	Ростовская обл.	89213336	64581199	24632137	38.14
76	76	РосинтерБанк	226	Москва и обл.	88805929	23122638	65683291	284.06
77	-41	Дойче Банк	3328	Москва и обл.	86758352	170515233	-83756881	-49.12
78	14	Бинбанк кредитные карты	2827	Москва и обл.	81251914	51038703	30213211	59.2
79	21	Таврический	2304	Санкт-Петербург и обл.	79711638	43472351	36239287	83.36
80	264	Банк Финсервис	3388	Москва и обл.	75121926	6463743	68658183	1062.20
81	134	Военно-Промышленный Банк	3065	Москва и обл.	73672261	15213889	58458372	384.24
82	-12	Банк Интеза	2216	Москва и обл.	73568451	81724535	-8156084	-9.98
83	622	Лето Банк	650	Москва и обл.	72211281	1195546	71015735	5940.03
84	-27	Эйч-Эс-Би-Си Банк (HSBC)	3290	Москва и обл.	71604307	101728610	-30124303	-29.61
85	137	АйСиБиСи Банк	3475	Москва и обл.	67242735	14266435	52976300	371.34
86	54	БФГ-Кредит	3068	Москва и обл.	65593923	25207031	40386892	160.22
87	-5	Металлинвестбанк	2440	Москва и обл.	65108438	63412208	1696230	2.67
88	-25	Юниаструм Банк	2771	Москва и обл.	64389462	90427375	-26037913	-28.79
89	39	Экспобанк	2998	Москва и обл.	64225502	30541437	33684065	110.29
90	12	Кубань Кредит	2518	Краснодарский край	63121464	42981620	20139844	46.86
91	63	Аверс	415	Татарстан	61242389	22928941	38313448	167.1
92	525	Российский Национальный Коммерческий Банк	1354	Симферополь	59657999	1773061	57884938	3264.69
93	51	Образование	1521	Москва и обл.	59496856	24879661	34617195	139.14
94	-11	Балтинвестбанк	3176	Санкт-Петербург и обл.	55956172	62468221	-6512049	-10.42
95	28	Росэнергобанк	2211	Москва и обл.	55509246	31213655	24295591	77.84
96	133	Бэнк оф Чайна	2309	Москва и обл.	55508094	12986973	42521121	327.41
97	-8	Международный Банк Санкт-Петербурга (МБСП)	197	Санкт-Петербург и обл.	53566090	52056401	1509689	2.9
98	84	Финпромбанк (ФПБ Банк)	2157	Москва и обл.	51505239	18201287	33303952	182.98
99	-9	Национальный Стандарт	3421	Москва и обл.	50892858	51687335	-794477	-1.54
100	5	Межтопэнергобанк	2956	Москва и обл.	49962227	37670059	12292168	32.63
101	2	Тойота Банк	3470	Москва и обл.	49878296	40789634	9088662	22.28
102	660	РН Банк	170	Москва и обл.	48401349	879242	47522107	5404.90
103	-18	Первобанк	3461	Самарская обл.	48267827	57180933	-8913106	-15.59
104	11	Фора-Банк	1885	Москва и обл.	47724048	33533818	14190230	42.32
105	4	Коммерцбанк (Евразия)	3333	Москва и обл.	47678680	34706431	12972249	37.38
106	11	СДМ-Банк	1637	Москва и обл.	47658112	33150606	14507506	43.76
107	83	БКС — Инвестиционный Банк	101	Новосибирская обл.	46704165	17199380	29504785	171.55
108	-15	Меткомбанк (Каменск-Уральский)	2443	Свердловская обл.	46001656	51015742	-5014086	-9.83
109	92	Газэнергобанк	3252	Калужская обл.	45422607	15997567	29425040	183.93
110	53	Сумитомо Мицуи	3494	Москва и обл.	45383679	21594408	23789271	110.16
111	24	Банк «МБА-Москва»	3395	Москва и обл.	45259943	26984069	18275874	67.73
112	58	ББР Банк	2929	Москва и обл.	44244585	20723965	23520620	113.49
113	34	Интерпрогрессбанк	600	Москва и обл.	43524275	24453765	19070510	77.99
114	154	Росэксимбанк	2790	Москва и обл.	43347831	9873735	33474096	339.02
115	-8	Примсоцбанк	2733	Приморский край	42378648	35803131	6575517	18.37
116	-6	Челиндбанк	485	Челябинская обл.	42296224	33959957	8336267	24.55
117	-9	Челябинвестбанк	493	Челябинская обл.	41523327	34975801	6547526	18.72
118	-56	Еврофинанс Моснарбанк	2402	Москва и обл.	40506119	90491009	-49984890	-55.24
119	46	Первый Чешско-Российский Банк	3291	Москва и обл.	39671737	21436247	18235490	85.07
120	2	Левобережный	1343	Новосибирская обл.	39463214	31718714	7744500	24.42
121	-7	Меткомбанк (Череповец)	901	Вологодская обл.	38586489	33650306	4936183	14.67
122	-11	Кольцо Урала	65	Свердловская обл.	38152691	33944479	4208212	12.4
123	-26	НС Банк	3124	Москва и обл.	37195488	45287894	-8092406	-17.87
124	-8	Саровбизнесбанк	2048	Нижегородская обл.	36251912	33232110	3019802	9.09
125	6	Интерпромбанк	3266	Москва и обл.	36169587	29253543	6916044	23.64
126	51	Фольксваген Банк Рус	3500	Москва и обл.	36107718	18986393	17121325	90.18
127	-9	Русский Международный Банк	3123	Москва и обл.	35266316	32835242	2431074	7.4
128	23	Советский	558	Санкт-Петербург и обл.	35250592	23220496	12030096	51.81
129	21	Русстройбанк	3205	Москва и обл.	33893169	23708325	10184844	42.96
130	11	Натиксис Банк	3390	Москва и обл.	32853934	25041123	7812811	31.2
131	64	Держава	2738	Москва и обл.	32075114	16605547	15469567	93.16
132	14	М2М Прайвет Банк	1414	Москва и обл.	31904419	24567866	7336553	29.86
133	-13	Кедр	1574	Красноярский край	31547376	32501996	-954620	-2.94
134	-9	Банк СГБ	2816	Вологодская обл.	31312164	30741231	570933	1.86
135	-58	Собинбанк	1317	Москва и обл.	31244778	72611320	-41366542	-56.97
136	6	Приморье	3001	Приморский край	30705340	24954473	5750867	23.05
137	24	Кредит Урал Банк	2584	Челябинская обл.	30445313	22108278	8337035	37.71
138	50	Тольяттихимбанк	2507	Самарская обл.	30315516	17376643	12938873	74.46
139	54	Мерседес-Бенц Банк Рус	3473	Москва и обл.	29727447	16812884	12914563	76.81
140	-1	БыстроБанк	1745	Удмуртия	29712502	25662433	4050069	15.78
141	46	Интехбанк	2705	Татарстан	29346043	17432545	11913498	68.34
142	-36	Дальневосточный Банк	843	Приморский край	29323206	37625908	-8302702	-22.07
143	109	ОФК Банк	2270	Москва и обл.	29048175	10639915	18408260	173.01
144	13	Солидарность (Самара)	554	Самарская обл.	28750476	22593245	6157231	27.25
145	75	АйМаниБанк	1975	Москва и обл.	28490801	14629717	13861084	94.75
146	86	Московское Ипотечное Агентство	3344	Москва и обл.	28376576	12818771	15557805	121.37
147	-17	Газбанк	2316	Самарская обл.	28091508	29641660	-1550152	-5.23
148	209	Объединенный Капитал	2611	Санкт-Петербург и обл.	27721751	5925715	21796036	367.82
149	491	Инвестиционный Республиканский Банк	2571	Москва и обл.	27502928	1593591	25909337	1625.85
150	5	Девон-Кредит	1972	Татарстан	27387771	22733317	4654454	20.47
151	187	Ишбанк	2867	Москва и обл.	27148006	6593528	20554478	311.74
152	44	Плюс Банк	1189	Москва и обл.	26650277	16455062	10195215	61.96
153	-4	Акибанк	2587	Татарстан	26607584	23921588	2685996	11.23
154	6	Москоммерцбанк	3365	Москва и обл.	26260376	22359444	3900932	17.45
155	55	АктивКапитал Банк	3006	Самарская обл.	25967510	15455177	10512333	68.02
156	-20	Липецккомбанк	1242	Липецкая обл.	25605653	26402539	-796886	-3.02
157	-56	Королевский Банк Шотландии	2594	Москва и обл.	25218457	43083878	-17865421	-41.47
158	11	Тимер Банк	1581	Татарстан	25215968	20797227	4418741	21.25
159	26	Легион	3117	Москва и обл.	25019364	17683334	7336030	41.49
160	-23	Агропромкредит	2880	Москва и обл.	24977236	26223366	-1246130	-4.75
161	3	Уральский Финансовый Дом	249	Пермская обл.	24643264	21588683	3054581	14.15
162		Чайна Констракшн	3515	Москва и обл.	24386473			
163	-10	Региональный Кредит	1927	Костромская обл.	24119063	23050219	1068844	4.64
164	111	Генбанк	2490	Москва и обл.	24047811	9475951	14571860	153.78
165	27	Алмазэргиэнбанк	2602	Саха (Якутия)	23722139	17019120	6703019	39.39
166	31	Морской Банк	77	Москва и обл.	23470795	16417200	7053595	42.96
167	8	Платежный Центр	3166	Новосибирская обл.	22595297	19416566	3178731	16.37
168	63	СтарБанк	548	Москва и обл.	22542033	12836814	9705219	75.6
169	37	Энерготрансбанк	1307	Калининградская обл.	22457903	15669868	6788035	43.32
170	41	Ланта-Банк	1920	Москва и обл.	22210505	15378484	6832021	44.43
171	-12	Альта-Банк	2269	Москва и обл.	22109373	22365215	-255842	-1.14
172	99	СЭБ Банк	3235	Санкт-Петербург и обл.	21844262	9791640	12052622	123.09
173	1	Спурт Банк	2207	Татарстан	21729708	20139870	1589838	7.89
174	10	Аресбанк	2914	Москва и обл.	21250792	17818591	3432201	19.26
175	-7	ФИА-Банк	2542	Самарская обл.	20923758	20963897	-40139	-0.19
176	26	НБД-Банк	1966	Нижегородская обл.	20707831	15936472	4771359	29.94
177	114	Башкомснаббанк	1398	Башкортостан	20586166	8569313	12016853	140.23
178	11	Энергобанк	67	Татарстан	20537611	17321813	3215798	18.57
179	34	Нацинвестпромбанк	3077	Москва и обл.	20187058	15282789	4904269	32.09
180		Морган Стэнли Банк	3456	Москва и обл.	19892165			
181	80	Социнвестбанк	1132	Башкортостан	19551838	10303350	9248488	89.76
182	22	Курскпромбанк	735	Курская обл.	19453119	15756327	3696792	23.46
183	33	ВУЗ-Банк	1557	Свердловская обл.	19393559	15080819	4312740	28.6
184	-28	БМВ Банк	3482	Москва и обл.	18849048	22730847	-3881799	-17.08
185	72	Рублев	3098	Москва и обл.	18438727	10486250	7952477	75.84
186	-90	Банк Кредит Свисс	2494	Москва и обл.	18382752	45396565	-27013813	-59.51
187	54	Денизбанк Москва	3330	Москва и обл.	18122511	11913483	6209028	52.12
188	-8	Развитие-Столица	3013	Москва и обл.	18114870	18683403	-568533	-3.04
189	25	Алеф-Банк	2119	Москва и обл.	17602440	15260917	2341523	15.34
190	181	Тройка-Д Банк	3431	Москва и обл.	17445124	5537034	11908090	215.06
191	46	Расчетно-Кредитный Банк	103	Москва и обл.	17326725	12561800	4764925	37.93
192	68	НК Банк	2755	Москва и обл.	17293046	10339231	6953815	67.26
193	33	Хлынов	254	Кировская обл.	17115331	13406869	3708462	27.66
194	90	Данске Банк	3307	Санкт-Петербург и обл.	17016420	9011509	8004911	88.83
195	160	Ури Банк	3479	Москва и обл.	16495687	6040363	10455324	173.09
196	186	Джей энд Ти Банк	3061	Москва и обл.	16386128	5242071	11144057	212.59
197	26	Центркомбанк	2983	Москва и обл.	16315400	13824629	2490771	18.02
198	-12	Уралтрансбанк	812	Свердловская обл.	16268903	17490860	-1221957	-6.99
199	-21	Петербургский Социальный Коммерческий Банк	2551	Санкт-Петербург и обл.	15965475	18949629	-2984154	-15.75
200	76	Гарант-Инвест	2576	Москва и обл.	15846151	9457839	6388312	67.55
201	-1	Форштадт	2208	Оренбургская обл.	15437483	16112200	-674717	-4.19
202	47	Русский Ипотечный Банк	1968	Москва и обл.	15367377	11111628	4255749	38.3
203	-5	Норвик Банк	902	Кировская обл.	15312834	16372668	-1059834	-6.47
204	24	Гранд Инвест Банк	3053	Москва и обл.	15255556	13203122	2052434	15.55
205	43	Росавтобанк	2767	Москва и обл.	15164035	11154019	4010016	35.95
206	-94	Национальный Резервный Банк	2170	Москва и обл.	15069713	33780775	-18711062	-55.39
207	73	Темпбанк	55	Москва и обл.	15047169	9071234	5975935	65.88
208	19	Росдорбанк	1573	Москва и обл.	14985395	13324452	1660943	12.47
209	45	Акцепт	567	Новосибирская обл.	14932481	10584803	4347678	41.07
210	15	ТЭМБР-Банк	2764	Москва и обл.	14597257	13553565	1043692	7.7
211	139	Татсоцбанк	480	Татарстан	14567837	6120184	8447653	138.03
212	53	БайкалБанк	2632	Бурятия	14106854	10102529	4004325	39.64
213	663	Российская Финансовая Корпорация	3099	Москва и обл.	14035227	371644	13663583	3676.52
214	-66	ГПБ-Ипотека	2403	Москва и обл.	13827458	24107144	-10279686	-42.64
215	-36	Пойдем!	2534	Москва и обл.	13779409	18711513	-4932104	-26.36
216	102	Дил-Банк	3384	Москва и обл.	13707960	7453972	6253988	83.9
217	102	Финансовый Стандарт	1053	Москва и обл.	13456822	7410290	6046532	81.6
218	26	Прио-Внешторгбанк	212	Рязанская обл.	13008951	11537147	1471804	12.76
219	110	Агросоюз	1459	Москва и обл.	12992660	7006132	5986528	85.45
220	47	Нефтяной Альянс	2859	Москва и обл.	12900760	9921805	2978955	30.02
221	45	Международный Акционерный Банк	1987	Москва и обл.	12713317	9923102	2790215	28.12
222	17	Солидарность (Москва)	1555	Москва и обл.	12514847	12475429	39418	0.32
223	328	Инбанк	1829	Москва и обл.	12490582	2303950	10186632	442.14
224	171	Объединенный Кредитный Банк	1118	Ярославская обл.	12365067	4990028	7375039	147.8
225	87	Русьуниверсалбанк	3293	Москва и обл.	12348433	7691532	4656901	60.55
226	88	Солид Банк	1329	Камчатская обл.	12127937	7672070	4455867	58.08
227	72	КС Банк	1752	Мордовия	11599914	8133097	3466817	42.63
228	-29	Первомайский	518	Краснодарский край	11507303	16359847	-4852544	-29.66
229	152	Нижневолжский Коммерческий Банк	931	Саратовская обл.	11430471	5362121	6068350	113.17
230	215	Стратегия	2801	Москва и обл.	11425221	3681186	7744035	210.37
231	129	Русский Торговый Банк	2842	Москва и обл.	11406349	5919150	5487199	92.7
232	93	Ренессанс	1939	Москва и обл.	11346975	7137163	4209812	58.98
233	-9	Национальная Факторинговая Компания	3437	Москва и обл.	11261621	13770922	-2509301	-18.22
234	86	Автоторгбанк	2776	Москва и обл.	11234709	7321589	3913120	53.45
235	530	Арксбанк	1868	Москва и обл.	11134937	855462	10279475	1201.63
236	98	Развитие	2729	Карачаево-Черкесия	10973888	6763213	4210675	62.26
237	94	ЕвроситиБанк	1869	Москва и обл.	10908772	6904616	4004156	57.99
238	-8	СИАБ	3245	Санкт-Петербург и обл.	10807780	12839605	-2031825	-15.82
239	30	Оренбург	3269	Оренбургская обл.	10805390	9828474	976916	9.94
240	84	Промтрансбанк	2638	Башкортостан	10783605	7145224	3638381	50.92
241	-22	Гаранти Банк — Москва	3275	Москва и обл.	10726813	14688758	-3961945	-26.97
242	67	Банк Жилищного Финансирования	3138	Москва и обл.	10684064	7847712	2836352	36.14
243	625	Кошелев-Банк	3300	Самарская обл.	10656937	415463	10241474	2465.07
244	-32	Александровский	53	Санкт-Петербург и обл.	10559753	15353895	-4794142	-31.22
245	8	Унифин	2654	Москва и обл.	10412097	10620950	-208853	-1.97
246	55	Нико-Банк	702	Оренбургская обл.	10363527	8100565	2262962	27.94
247	3	Киви Банк	2241	Москва и обл.	10227569	11033359	-805790	-7.3
248	46	Славия	2664	Москва и обл.	10141643	8529341	1612302	18.9
249	-40	Энергомашбанк	52	Санкт-Петербург и обл.	9882559	15484869	-5602310	-36.18
250	114	Ассоциация	732	Нижегородская обл.	9878213	5707992	4170221	73.06
251	72	Хованский	2145	Москва и обл.	9729713	7181670	2548043	35.48
252	70	Ставропольпромстройбанк	1288	Ставропольский край	9580120	7273838	2306282	31.71
253	160	Новопокровский	467	Краснодарский край	9392165	4555348	4836817	106.18
254	83	Банк Казани	708	Татарстан	9363286	6616443	2746843	41.52
255	18	Кредит-Москва	5	Москва и обл.	9278911	9558824	-279913	-2.93
256	-10	Миллениум Банк	3423	Москва и обл.	9275519	11358239	-2082720	-18.34
257	73	Япы Креди Банк Москва	2555	Москва и обл.	9220459	6953086	2267373	32.61
258	429	Финанс Бизнес Банк	520	Москва и обл.	9193031	1281011	7912020	617.64
259	47	Снежинский	1376	Челябинская обл.	9149543	7979173	1170370	14.67
260	66	Ижкомбанк	646	Удмуртия	8894474	7104991	1789483	25.19
261	124	Банк БКФ	2684	Москва и обл.	8879856	5190754	3689102	71.07
262	49	Северо-Восточный Альянс	2768	Москва и обл.	8865073	7709701	1155372	14.99
263	111	Таатта	1249	Саха (Якутия)	8845172	5446346	3398826	62.41
264	102	Вокбанк	312	Нижегородская обл.	8832439	5680431	3152008	55.49
265	-3	Екатеринбург	3161	Свердловская обл.	8796759	10290878	-1494119	-14.52
266	-100	Мир Бизнес Банк	3396	Москва и обл.	8784113	21241316	-12457203	-58.65
267	-46	Гута-Банк	256	Москва и обл.	8652984	14371106	-5718122	-39.79
268	280	Верхневолжский	1084	Ярославская обл.	8630585	2335539	6295046	269.53
269	132	Нефтепромбанк	2156	Москва и обл.	8584044	4939644	3644400	73.78
270	88	Московский Нефтехимический Банк	1411	Москва и обл.	8459969	5925420	2534549	42.77
271	-29	ЯР-Банк	3185	Москва и обл.	8458492	11692598	-3234106	-27.66
272	61	Томскпромстройбанк	1720	Томская обл.	8442573	6795472	1647101	24.24
273	42	ПИР Банк	2655	Москва и обл.	8422975	7613387	809588	10.63
274	72	Юг-Инвестбанк	2772	Краснодарский край	8356750	6374495	1982255	31.1
275	-30	РусЮгбанк	2093	Волгоградская обл.	8241611	11434197	-3192586	-27.92
276	80	Альба Альянс	2593	Москва и обл.	8179879	5936749	2243130	37.78
277	62	Рускобанк	138	Санкт-Петербург и обл.	8062152	6592559	1469593	22.29
278	58	Эксперт Банк	2949	Омская обл.	7900991	6646923	1254068	18.87
279	37	Современный Коммерческий Ипотечный Банк	3329	Костромская обл.	7780975	7564130	216845	2.87
280	176	Синко-Банк	2838	Москва и обл.	7768186	3440678	4327508	125.77
281	47	Финам Банк	2799	Москва и обл.	7765804	7051267	714537	10.13
282	450	МС Банк Рус	2789	Москва и обл.	7631451	1016364	6615087	650.86
283	-4	Белгородсоцбанк	760	Белгородская обл.	7598159	9097064	-1498905	-16.48
284	70	Славянский Кредит	2960	Москва и обл.	7549773	6065674	1484099	24.47
285	64	Бинбанк Тверь	777	Тверская обл.	7523907	6204013	1319894	21.27
286	-46	Углеметбанк	2997	Челябинская обл.	7521772	12084453	-4562681	-37.76
287	129	Северный Кредит	2398	Вологодская обл.	7521079	4506860	3014219	66.88
288	167	Консервативный Коммерческий Банк	1087	Астраханская обл.	7507137	3455342	4051795	117.26
289	155	Союзный	3236	Москва и обл.	7435775	3683595	3752180	101.86
290	18	Экспресс-Кредит	210	Москва и обл.	7294232	7864573	-570341	-7.25
291	86	Чувашкредитпромбанк	1280	Чувашия	7258465	5398643	1859822	34.45
292	104	Анкор Банк	889	Татарстан	7246739	4979595	2267144	45.53
293	83	Риабанк	3434	Москва и обл.	7223779	5421660	1802119	33.24
294	98	Век	2299	Москва и обл.	7213831	5074244	2139587	42.17
295	293	Торговый Городской Банк	3180	Тверская обл.	7211381	2021312	5190069	256.77
296	49	Муниципальный Камчатпрофитбанк	2103	Камчатская обл.	7138784	6377841	760943	11.93
297	76	Голдман Сакс Банк	3490	Москва и обл.	7135798	5446588	1689210	31.01
298	520	Кубаньторгбанк	478	Краснодарский край	7009508	591220	6418288	1085.60
299	-16	Ю Би Эс Банк	3463	Москва и обл.	7008214	9026843	-2018629	-22.36
300	84	Трансстройбанк	2807	Москва и обл.	7007445	5238623	1768822	33.77
301	52	Банк на Красных Воротах	2472	Москва и обл.	6916530	6071174	845356	13.92
302	166	Азия-Инвест Банк	3303	Москва и обл.	6910754	3261941	3648813	111.86
303	37	Русь	704	Оренбургская обл.	6764786	6556023	208763	3.18
304	-30	Вега-Банк	3270	Москва и обл.	6700477	9509517	-2809040	-29.54
305	12	Кузнецкбизнесбанк	1158	Кемеровская обл.	6667224	7527837	-860613	-11.43
306	-19	Банк Торгового Финансирования	1982	Москва и обл.	6647149	8687271	-2040122	-23.48
307	118	Эл Банк	1025	Самарская обл.	6593412	4259154	2334258	54.81
308	55	Бинбанк Мурманск	1276	Мурманская обл.	6591681	5762538	829143	14.39
309	-17	Роспромбанк	3204	Москва и обл.	6590435	8551038	-1960603	-22.93
310	62	Актив Банк	2529	Мордовия	6547498	5447098	1100400	20.2
311	164	Эргобанк	2856	Москва и обл.	6546524	3194083	3352441	104.96
312	148	Русский Трастовый Банк	1139	Москва и обл.	6509501	3374014	3135487	92.93
313	479	Воронеж	654	Воронежская обл.	6499671	719760	5779911	803.03
314	27	Новый Московский Банк	2932	Москва и обл.	6447996	6535062	-87066	-1.33
315	134	РЕСО Кредит	3450	Москва и обл.	6444090	3569934	2874156	80.51
316	-20	Руснарбанк	3403	Москва и обл.	6411313	8379849	-1968536	-23.49
317	63	Нэклис-Банк	1671	Москва и обл.	6411235	5364076	1047159	19.52
318	81	Кремлевский	2905	Москва и обл.	6404503	4950967	1453536	29.36
319	179	Коммерческий Индо Банк	3446	Москва и обл.	6271630	2887631	3383999	117.19
320	90	Кранбанк	2271	Ивановская обл.	6262099	4675397	1586702	33.94
321	-104	Банк ПСА Финанс Рус	3481	Москва и обл.	6197279	14885073	-8687794	-58.37
322	185	Енисей	474	Красноярский край	6163263	2790590	3372673	120.86
323	-19	Экси-Банк	2530	Санкт-Петербург и обл.	6126992	8006252	-1879260	-23.47
324	90	Банкхаус Эрбе	1717	Москва и обл.	6094503	4552901	1541602	33.86
325	-43	Объединенная Расчетная Система	3342	Москва и обл.	6015399	9026993	-3011594	-33.36
326	67	Межтрастбанк	2493	Москва и обл.	5998144	5042517	955627	18.95
327	93	Проминвестбанк	2433	Москва и обл.	5989690	4442240	1547450	34.83
328	240	Идея Банк	430	Краснодарский край	5951602	2178277	3773325	173.23
329	46	Северный Народный Банк	2721	Коми	5902967	5427209	475758	8.77
330	94	Хакасский Муниципальный Банк	1049	Хакасия	5888530	4351068	1537462	35.34
331	17	ФДБ	3071	Москва и обл.	5856032	6253546	-397514	-6.36
332	29	Банк Оранжевый	1659	Санкт-Петербург и обл.	5854129	5888419	-34290	-0.58
333	93	Нейва	1293	Свердловская обл.	5762628	4255335	1507293	35.42
334	250	Ринвестбанк	3262	Рязанская обл.	5749444	2046865	3702579	180.89
335	174	Мираф-Банк	2244	Омская обл.	5718304	2785128	2933176	105.32
336	50	Бинбанк Смоленск	1957	Смоленская обл.	5676186	5174008	502178	9.71
337	5	Автоградбанк	1455	Татарстан	5606025	6532475	-926450	-14.18
338	194	Итуруп	2390	Сахалинская обл.	5526339	2487700	3038639	122.15
339	109	Милбанк	3256	Москва и обл.	5514438	3586579	1927859	53.75
340	79	Енисейский Объединенный Банк	2645	Красноярский край	5500513	4449272	1051241	23.63
341	80	Газстройбанк	2919	Москва и обл.	5480556	4431046	1049510	23.69
342	110	Мосуралбанк	2468	Москва и обл.	5462552	3492711	1969841	56.4
343	65	Банк Раунд	2506	Москва и обл.	5434099	4693565	740534	15.78
344	90	Промрегионбанк	2123	Томская обл.	5423065	4046251	1376814	34.03
345	260	РТС-Банк	3401	Самарская обл.	5411133	1864304	3546829	190.25
346	48	Камский Коммерческий Банк	438	Татарстан	5337730	5027129	310601	6.18
347	119	Сити Инвест Банк	3194	Санкт-Петербург и обл.	5290843	3280314	2010529	61.29
348	143	НБК-Банк	3283	Москва и обл.	5254978	2963238	2291740	77.34
349	196	Владпромбанк	870	Владимирская обл.	5217975	2343546	2874429	122.65
350		Кореа Эксчендж Банк Рус	3525	Москва и обл.	5169988			
351	58	Донкомбанк	492	Ростовская обл.	5153821	4693369	460452	9.81
352	-64	Уралкапиталбанк	2519	Башкортостан	5129346	8670571	-3541225	-40.84
353	16	Сибсоцбанк	2015	Алтайский край	5113152	5599210	-486058	-8.68
354	-11	Национальный Залоговый Банк	2944	Москва и обл.	5060130	6486157	-1426027	-21.99
355	-42	Банк БЦК-Москва	3480	Москва и обл.	5032427	7684888	-2652461	-34.52
356	219	Конфидэнс Банк	970	Костромская обл.	4963766	2140557	2823209	131.89
357	81	Новобанк	1352	Новгородская обл.	4955659	3929257	1026402	26.12
358	156	Московский Коммерческий Банк	3172	Москва и обл.	4891539	2710442	2181097	80.47
359	81	Межрегиональный промышленно-строительный банк	752	Мордовия	4890837	3852660	1038177	26.95
360	55	ВостСибтранскомбанк	2731	Иркутская обл.	4812604	4531810	280794	6.2
361	232	Приско Капитал Банк	2537	Москва и обл.	4788554	1972024	2816530	142.82
362	77	Земский Банк	2900	Самарская обл.	4784209	3891575	892634	22.94
363	-28	Банк Инноваций и Развития	2647	Москва и обл.	4777648	6686781	-1909133	-28.55
364	83	Москва-Сити	3247	Москва и обл.	4749690	3636618	1113072	30.61
365	41	Промэнергобанк	2728	Вологодская обл.	4688680	4775129	-86449	-1.81
366	310	Газтрансбанк	665	Адыгея	4649157	1338241	3310916	247.41
367	55	Зенит Сочи	232	Краснодарский край	4631615	4387527	244088	5.56
368	-87	Платина	2347	Москва и обл.	4630912	9048345	-4417433	-48.82
369	173	ФорБанк	2063	Москва и обл.	4630597	2374775	2255822	94.99
370	67	Заречье	817	Татарстан	4575485	3940289	635196	16.12
371	27	Банк Развития Технологий	3441	Москва и обл.	4566994	4964824	-397830	-8.01
372	19	Экономикс-Банк	2136	Москва и обл.	4560262	5096526	-536264	-10.52
373	129	Уссури	596	Хабаровский край	4512186	2861112	1651074	57.71
374	176	Промсельхозбанк	538	Москва и обл.	4496002	2326553	2169449	93.25
375	291	Европлан Банк	3052	Москва и обл.	4478921	1402214	3076707	219.42
376	70	Кузнецкий	609	Пензенская обл.	4438072	3673086	764986	20.83
377	337	Капиталбанк	2547	Ростовская обл.	4390524	1130429	3260095	288.39
378	128	Сибирский Банк Реконструкции и Развития	1284	Тюменская обл.	4386782	2842366	1544416	54.34
379	116	Финансово-Промышленный Капитал	3295	Москва и обл.	4366112	2939915	1426197	48.51
380	106	Венец	524	Ульяновская обл.	4244193	3051754	1192439	39.07
381	70	Камчаткомагропромбанк	545	Камчатская обл.	4221768	3511609	710159	20.22
382	81	Роял Кредит Банк	783	Хабаровский край	4171708	3334439	837269	25.11
383	383	Прайм Финанс	2758	Санкт-Петербург и обл.	4135941	847681	3288260	387.91
384		Чайнасельхозбанк	3529	Москва и обл.	4129408			
385	85	Форус Банк	3457	Нижегородская обл.	4111135	3252138	858997	26.41
386	79	Витабанк	356	Санкт-Петербург и обл.	4083034	3290234	792800	24.1
387	-77	Международный Коммерческий Банк	2524	Москва и обл.	4072170	7735466	-3663296	-47.36
388	24	Стройлесбанк	2995	Тюменская обл.	4009010	4578239	-569229	-12.43
389	267	Русский Национальный Банк	469	Ростовская обл.	3902794	1465458	2437336	166.32
390	93	Горбанк	2982	Санкт-Петербург и обл.	3871569	3092714	778855	25.18
391	62	Крыловский	456	Краснодарский край	3854733	3491623	363110	10.4
392	-14	Кузнецкий Мост	2254	Москва и обл.	3846924	5396124	-1549200	-28.71
393	124	Вологжанин	1896	Вологодская обл.	3835921	2689704	1146217	42.61
394	48	Интернациональный Торговый Банк	2609	Омская обл.	3832231	3711447	120784	3.25
395	-43	Руссобанк	2313	Москва и обл.	3804503	6073028	-2268525	-37.35
396	129	Агророс	2860	Саратовская обл.	3796118	2570558	1225560	47.68
397	39	Земкомбанк	574	Ростовская обл.	3775686	3943715	-168029	-4.26
398	140	МФБанк	3163	Москва и обл.	3745267	2447177	1298090	53.04
399	8	БайкалИнвестБанк	1067	Иркутская обл.	3731550	4721077	-989527	-20.96
400	89	Невский Банк	1068	Санкт-Петербург и обл.	3729647	2984865	744782	24.95
401	171	Айви Банк	2055	Москва и обл.	3714564	2161699	1552865	71.84
402	187	Выборг-Банк	720	Санкт-Петербург и обл.	3707876	2014485	1693391	84.06
403	38	Мастер-Капитал	3011	Москва и обл.	3705583	3798719	-93136	-2.45
404	149	Объединенный Резервный Банк	937	Москва и обл.	3704698	2291966	1412732	61.64
405	306	Метрополь	1639	Москва и обл.	3675617	1171604	2504013	213.73
406	105	Евразийский Банк	969	Москва и обл.	3664450	2751279	913171	33.19
407	87	Аксонбанк	680	Костромская обл.	3656481	2950767	705714	23.92
408	104	Инвестсоцбанк	3010	Москва и обл.	3652688	2727777	924911	33.91
409	14	Межрегиональный Почтовый Банк	3171	Москва и обл.	3632492	4354845	-722353	-16.59
410	281	Банкирский Дом	2928	Санкт-Петербург и обл.	3577688	1256986	2320702	184.62
411	71	Уралпромбанк	2964	Челябинская обл.	3573762	3095497	478265	15.45
412	204	Бест Эффортс Банк	435	Москва и обл.	3557080	1783089	1773991	99.49
413	48	Живаго-Банк	2065	Рязанская обл.	3556737	3343430	213307	6.38
414	187	Донхлеббанк	2285	Ростовская обл.	3545470	1895630	1649840	87.03
415	242	Московско-Парижский Банк	2646	Москва и обл.	3538981	1457617	2081364	142.79
416	-54	Веста	2368	Москва и обл.	3537304	5778680	-2241376	-38.79
417	141	Зираат Банк	2559	Москва и обл.	3527564	2254629	1272935	56.46
418	58	Уральский Межрегиональный Банк	1441	Свердловская обл.	3513042	3190911	322131	10.1
419		Н-Банк	3493	Москва и обл.	3511307			
420	65	Юнистрим	3467	Москва и обл.	3499389	3064868	434521	14.18
421	72	Наш Дом	3296	Москва и обл.	3470207	2959710	510497	17.25
422	112	Констанс-Банк	2228	Санкт-Петербург и обл.	3459651	2471693	987958	39.97
423	141	Кубанский Универсальный Банк	2898	Краснодарский край	3454653	2193034	1261619	57.53
424	91	Новое Время	3492	Москва и обл.	3449432	2701518	747914	27.68
425	32	Смартбанк	3408	Москва и обл.	3414201	3428500	-14299	-0.42
426	349	Мико-Банк	3195	Москва и обл.	3381095	786444	2594651	329.92
427	181	Рапида	3371	Москва и обл.	3350860	1837046	1513814	82.4
428	-10	Ермак	1809	Ханты-Мансийский АО — Югра	3319390	4451752	-1132362	-25.44
429	67	Росбизнесбанк	1405	Москва и обл.	3316004	2908340	407664	14.02
430	394	Центрально-Европейский Банк	2670	Москва и обл.	3308618	564881	2743737	485.72
431	263	Сибэс	208	Омская обл.	3307117	1248201	2058916	164.95
432	117	Крокус-Банк	2682	Москва и обл.	3304521	2333983	970538	41.58
433	206	Народный Доверительный Банк	2374	Москва и обл.	3302078	1596725	1705353	106.8
434	63	Нокссбанк	3202	Волгоградская обл.	3286819	2899375	387444	13.36
435	34	Алтайкапиталбанк	2659	Алтайский край	3269162	3257159	12003	0.37
436	22	Долинск	857	Сахалинская обл.	3257561	3415496	-157935	-4.62
437	128	Братский АНКБ	1144	Иркутская обл.	3247262	2189175	1058087	48.33
438	416	Ростфинанс	481	Ростовская обл.	3220924	466554	2754370	590.36
439	-169	Международный Банк Развития	2704	Москва и обл.	3205280	9809226	-6603946	-67.32
440	39	Интеркредит	3047	Москва и обл.	3188758	3138695	50063	1.6
441	21	Церих	3278	Орловская обл.	3187906	3338331	-150425	-4.51
442	140	Мегаполис	3265	Чувашия	3182459	2083083	1099376	52.78
443	124	Иваново	1763	Ивановская обл.	3162815	2179622	983193	45.11
444	285	Региональный Коммерческий Банк	836	Ульяновская обл.	3153258	1032103	2121155	205.52
445	32	Океан Банк	1697	Москва и обл.	3128233	3170499	-42266	-1.33
446	64	Элита	1399	Калужская обл.	3114124	2753768	360356	13.09
447		Яндекс.Деньги	3510	Россия	3113796			
448	161	Лайтбанк	3177	Москва и обл.	3104832	1834375	1270457	69.26
449	341	Банк Премьер Кредит	1663	Москва и обл.	3076655	725890	2350765	323.85
450	-19	Оргбанк	3312	Москва и обл.	3070857	4064900	-994043	-24.45
451	79	Аспект	608	Москва и обл.	3035050	2522454	512596	20.32
452	273	Первый Клиентский Банк	3436	Москва и обл.	2991255	1057492	1933763	182.86
453	128	Радиотехбанк	1166	Нижегородская обл.	2966138	2091039	875099	41.85
454	20	Тамбовкредитпромбанк	1312	Тамбовская обл.	2901765	3197276	-295511	-9.24
455	26	РБА	3413	Москва и обл.	2888258	3120904	-232646	-7.45
456	17	Интерактивный Банк	3378	Москва и обл.	2883744	3227967	-344223	-10.66
457	358	Банк ВВБ	1093	Севастополь	2859686	599460	2260226	377.04
458	22	Кроссинвестбанк	2849	Москва и обл.	2842938	3125920	-282982	-9.05
459	-16	Евроальянс	1781	Ивановская обл.	2834395	3686806	-852411	-23.12
460	177	Межбанковский Кредитный Союз	3242	Москва и обл.	2801085	1608352	1192733	74.16
461	398	Еврокапитал-Альянс	2672	Ярославская обл.	2786919	446389	2340530	524.33
462	22	Банк Экономический Союз	2798	Москва и обл.	2777152	3083996	-306844	-9.95
463	244	Заубер Банк	1614	Санкт-Петербург и обл.	2767244	1179185	1588059	134.67
464	113	Кросна-Банк	2607	Москва и обл.	2756487	2117574	638913	30.17
465	51	Костромаселькомбанк	1115	Костромская обл.	2755517	2697774	57743	2.14
466	38	ЕвроАксис Банк	3273	Москва и обл.	2710901	2850108	-139207	-4.88
467	54	Богородский	1277	Нижегородская обл.	2641702	2612619	29083	1.11
468	55	Система	2846	Москва и обл.	2628570	2589103	39467	1.52
469	157	Кредит Экспресс	3186	Ростовская обл.	2616536	1703280	913256	53.62
470	91	Йошкар-Ола	2802	Марий Эл	2604872	2239017	365855	16.34
471	107	Проинвестбанк	784	Пермская обл.	2585471	2115161	470310	22.24
472	31	Преодоление	2649	Москва и обл.	2584107	2855967	-271860	-9.52
473	49	Апабанк	2404	Москва и обл.	2556531	2610032	-53501	-2.05
474	130	Газнефтьбанк	3223	Саратовская обл.	2546713	1887479	659234	34.93
475	171	Канский	860	Красноярский край	2546093	1553513	992580	63.89
476	110	Вестерн Юнион ДП Восток	2726	Москва и обл.	2544514	2031673	512841	25.24
477	69	Промышленно-Финансовое Сотрудничество	2410	Москва и обл.	2540451	2336645	203806	8.72
478	135	Владбизнесбанк	903	Владимирская обл.	2539316	1803129	736187	40.83
479	382	K2 Банк	2851	Карачаево-Черкесия	2526348	442181	2084167	471.34
480	-13	Еврокредит	2957	Москва и обл.	2519476	3276078	-756602	-23.09
481	139	Унифондбанк	3416	Москва и обл.	2482124	1751316	730808	41.73
482	74	Национальный Корпоративный Банк	3422	Москва и обл.	2469866	2257341	212525	9.41
483	129	Столичный Кредит	2853	Москва и обл.	2450587	1806621	643966	35.64
484	101	Михайловский ПЖСБ	2961	Волгоградская обл.	2447057	2044374	402683	19.7
485	358	Внешфинбанк	3173	Краснодарский край	2445101	502085	1943016	386.99
486	47	ИРС	272	Москва и обл.	2441123	2478586	-37463	-1.51
487	162	Народный Банк	2249	Карачаево-Черкесия	2397401	1506944	890457	59.09
488	369	Соверен Банк	3206	Москва и обл.	2381762	460249	1921513	417.49
489	-2	Первый Инвестиционный банк	604	Москва и обл.	2371218	3026804	-655586	-21.66
490	101	Новация	840	Адыгея	2371157	2012280	358877	17.83
491	142	БСТ-Банк	2883	Кемеровская обл.	2370338	1637736	732602	44.73
492	45	Резерв	2364	Челябинская обл.	2358966	2455400	-96434	-3.93
493	139	Татагропромбанк	728	Татарстан	2352605	1640239	712366	43.43
494	335	Тальменка-Банк	826	Алтайский край	2332670	557547	1775123	318.38
495	108	Викинг	2	Санкт-Петербург и обл.	2321699	1888547	433152	22.94
496	147	Златкомбанк	568	Москва и обл.	2265506	1586332	679174	42.81
497	74	Северо-Западный 1 Альянс Банк	766	Санкт-Петербург и обл.	2259821	2165788	94033	4.34
498	240	Международный Строительный Банк	3484	Москва и обл.	2247703	966839	1280864	132.48
499	56	Яринтербанк	2564	Ярославская обл.	2228750	2268466	-39716	-1.75
500	24	Вкабанк	1027	Астраханская обл.	2228103	2575497	-347394	-13.49
501	229	Миръ	3089	Москва и обл.	2224145	1029538	1194607	116.03
502	159	Далена	1948	Москва и обл.	2221645	1445680	775965	53.67
503	41	Новый Символ	370	Москва и обл.	2220085	2348388	-128303	-5.46
504	14	Капитал	575	Москва и обл.	2194772	2684188	-489416	-18.23
505	116	Торжокуниверсалбанк	933	Тверская обл.	2160795	1747051	413744	23.68
506	167	Екатерининский	2167	Москва и обл.	2156854	1356790	800064	58.97
507	403	Единый Строительный Банк	3506	Омская обл.	2118402	202853	1915549	944.3
508	323	Кредпромбанк	1165	Ярославская обл.	2095161	550530	1544631	280.57
509	43	Спиритбанк	2053	Тульская обл.	2073117	2295142	-222025	-9.67
510	33	Бум-Банк	1137	Кабардино-Балкария	2069065	2359237	-290172	-12.3
511	-3	Современные Стандарты Бизнеса	3397	Москва и обл.	2042670	2786682	-744012	-26.7
512	150	Уралфинанс	1370	Свердловская обл.	2036633	1444806	591827	40.96
513	193	Индустриальный Сберегательный Банк	3175	Москва и обл.	2034682	1179238	855444	72.54
514	113	Алтынбанк	2070	Татарстан	2022682	1698324	324358	19.1
515	110	Московский Вексельный Банк	2697	Москва и обл.	2006188	1718947	287241	16.71
516	187	Мосводоканалбанк	2863	Москва и обл.	2005590	1198166	807424	67.39
517	-58	Финансовый Капитал	3288	Санкт-Петербург и обл.	2001445	3393995	-1392550	-41.03
518	44	Пермь	875	Пермская обл.	2001216	2237968	-236752	-10.58
519	250	ЮМК	3495	Краснодарский край	1947154	845509	1101645	130.29
520	82	Старооскольский Агропромбанк	1050	Белгородская обл.	1936746	1892677	44069	2.33
521	-89	Бинбанк Сургут	1701	Ханты-Мансийский АО — Югра	1933209	4062464	-2129255	-52.41
522	219	Америкэн Экспресс Банк	3460	Москва и обл.	1914641	953814	960827	100.74
523	-22	Риал-Кредит	3393	Москва и обл.	1896195	2862530	-966335	-33.76
524	171	Глобус	2438	Москва и обл.	1889400	1244741	644659	51.79
525	72	Россита-Банк	3257	Москва и обл.	1873773	1940991	-67218	-3.46
526	155	Булгар Банк	1917	Татарстан	1861691	1313312	548379	41.76
527	172	Акцент	696	Оренбургская обл.	1850214	1222381	627833	51.36
528	59	Стелла-Банк	2948	Ростовская обл.	1839473	2029146	-189673	-9.35
529	51	КОР	2148	Волгоградская обл.	1839079	2098667	-259588	-12.37
530	66	Социум-Банк	2881	Москва и обл.	1837207	1943093	-105886	-5.45
531	107	Мострансбанк	2258	Москва и обл.	1819213	1601030	218183	13.63
532	143	Вологдабанк	992	Вологодская обл.	1813058	1338654	474404	35.44
533	77	Руна-Банк	3207	Москва и обл.	1797115	1815448	-18333	-1.01
534	175	Кетовский Коммерческий Банк	842	Курганская обл.	1787144	1176413	610731	51.91
535	72	Крона-Банк	2499	Иркутская обл.	1769625	1840124	-70499	-3.83
536	152	Майкопбанк	1136	Адыгея	1768764	1280057	488707	38.18
537	61	Нальчик	695	Кабардино-Балкария	1768378	1940400	-172022	-8.87
538	106	Холмск	503	Сахалинская обл.	1753329	1583935	169394	10.69
539	37	Дом-Банк	3209	Москва и обл.	1749007	2124650	-375643	-17.68
540	110	Межрегиональный Клиринговый Банк	2543	Москва и обл.	1739928	1488158	251770	16.92
541	300	РУБанк	2813	Москва и обл.	1726380	518869	1207511	232.72
542	88	Кемсоцинбанк	96	Кемеровская обл.	1694451	1649242	45209	2.74
543		Икано Банк	3519	Центр	1687103			
544	62	Банк МБФИ	2073	Москва и обл.	1684187	1842604	-158417	-8.6
545	28	Тагилбанк	1635	Свердловская обл.	1656600	2152210	-495610	-23.03
546	46	Вэлтон Банк	1105	Белгородская обл.	1649418	2000361	-350943	-17.54
547	106	Приобье	537	Ханты-Мансийский АО — Югра	1618801	1472147	146654	9.96
548	321	1Банк	2896	Северная Осетия — Алания	1594867	414343	1180524	284.91
549	167	Мурманский Расчетный Центр	3341	Мурманская обл.	1589139	1107267	481872	43.52
550	108	Примтеркомбанк	21	Приморский край	1577183	1456180	121003	8.31
551	108	Великие Луки Банк	598	Псковская обл.	1574847	1453285	121562	8.36
552	176	Сельмашбанк	106	Ростовская обл.	1571993	1036817	535176	51.62
553	119	Ноосфера	2650	Республика Алтай	1564310	1362404	201906	14.82
554	-34	Коммерческий Банк Развития	3364	Москва и обл.	1545235	2613516	-1068281	-40.88
555	130	Калуга	1151	Калужская обл.	1543614	1293308	250306	19.35
556		Оней Банк	3516	Москва и обл.	1540248			
557	54	Соколовский	2830	Москва и обл.	1539609	1807185	-267576	-14.81
558	-19	ИК Банк	1732	Татарстан	1535155	2433742	-898587	-36.92
559	77	Новый Кредитный Союз	3139	Москва и обл.	1526368	1622302	-95934	-5.91
560	123	Спутник	1071	Оренбургская обл.	1509651	1304632	205019	15.71
561	295	Вятич	2796	Рязанская обл.	1500006	462479	1037527	224.34
562	-98	Инкаробанк	2696	Москва и обл.	1496667	3318755	-1822088	-54.9
563	111	Гринкомбанк	1184	Иркутская обл.	1494436	1350565	143871	10.65
564	193	Евроазиатский Инвестиционный Банк	2897	Москва и обл.	1493706	894178	599528	67.05
565	159	Первый Дортрансбанк	3271	Кировская обл.	1449380	1061289	388091	36.57
566	325	Регнум	3373	Москва и обл.	1437759	300558	1137201	378.36
567	183	Арзамас	1281	Нижегородская обл.	1433388	926699	506689	54.68
568	-11	РФИ Банк	3351	Москва и обл.	1432609	2256165	-823556	-36.5
569	-3	Кредитинвест	1197	Дагестан	1422893	2186591	-763698	-34.93
570	94	Жилкредит	1736	Москва и обл.	1417934	1431141	-13207	-0.92
571	155	Почтобанк	1788	Пермская обл.	1412392	1039973	372419	35.81
572	79	Саратов	330	Саратовская обл.	1395717	1479708	-83991	-5.68
573	1	Пульс Столицы	3002	Москва и обл.	1384697	2142896	-758199	-35.38
574	174	Взаимодействие	1704	Новосибирская обл.	1382603	935703	446900	47.76
575	144	Синергия	2884	Саратовская обл.	1371915	1079881	292034	27.04
576	-45	Банк РМП	2574	Москва и обл.	1353074	2514757	-1161683	-46.19
577	109	Саммит Банк	85	Приморский край	1345615	1289110	56505	4.38
578		ПэйПал РУ	3517	Москва и обл.	1292588			
579	-10	Сталь Банк	2248	Москва и обл.	1275044	2174517	-899473	-41.36
580	43	Сервис-Резерв	2034	Москва и обл.	1251450	1721551	-470101	-27.31
581	178	МТИ-Банк	1052	Москва и обл.	1225159	887556	337603	38.04
582	186	Арсенал	3000	Москва и обл.	1225030	846809	378221	44.66
583	180	Динамичные Системы	3439	Москва и обл.	1219769	861438	358331	41.6
584	-112	Тендер-Банк	2252	Москва и обл.	1215979	3242571	-2026592	-62.5
585	148	Химик	1114	Нижегородская обл.	1196427	1015926	180501	17.77
586	110	Санкт-Петербургский Банк Инвестиций	3468	Санкт-Петербург и обл.	1195323	1237402	-42079	-3.4
587	54	Новый Промышленный Банк	930	Москва и обл.	1189889	1593318	-403429	-25.32
588	40	Национальный Банк Взаимного Кредита	3214	Москва и обл.	1184069	1660461	-476392	-28.69
589	208	Космос	2245	Москва и обл.	1182618	702606	480012	68.32
590	94	Максима	3379	Москва и обл.	1181475	1296001	-114526	-8.84
591	202	НоваховКапиталБанк	635	Москва и обл.	1177963	714850	463113	64.78
592	150	Финарс Банк	2938	Москва и обл.	1161064	951565	209499	22.02
593	185	Камский Горизонт	2554	Татарстан	1149427	778359	371068	47.67
594	-35	Финтрастбанк	3104	Москва и обл.	1133371	2249380	-1116009	-49.61
595	269	Южный Региональный Банк	3015	Ростовская обл.	1118583	431913	686670	158.98
596	58	Русский Элитарный Банк	3231	Москва и обл.	1099141	1470002	-370861	-25.23
597	72	Акрополь	3027	Москва и обл.	1091477	1397868	-306391	-21.92
598	154	Тетраполис	1586	Санкт-Петербург и обл.	1087731	922189	165542	17.95
599	36	Металлург	2877	Москва и обл.	1080206	1633356	-553150	-33.87
600	236	Москва	1661	Москва и обл.	1063879	535056	528823	98.84
601	133	ЕАТП Банк	1765	Астраханская обл.	1062758	1008156	54602	5.42
602	106	Дон-Тексбанк	1818	Ростовская обл.	1062135	1177926	-115791	-9.83
603	114	Регионфинансбанк	3357	Москва и обл.	1059621	1096712	-37091	-3.38
604	59	Республиканский Кредитный Альянс	3017	Москва и обл.	1054509	1436070	-381561	-26.57
605	126	Мурманский Социальный Коммерческий Банк	2722	Мурманская обл.	1048048	1020037	28011	2.75
606	134	Московский Клиринговый Центр	3314	Москва и обл.	1047646	961832	85814	8.92
607	120	Курган	2568	Курганская обл.	1039874	1039184	690	0.07
608	92	Онего	2484	Карелия	1019876	1220583	-200707	-16.44
609	194	Невастройинвест	1926	Санкт-Петербург и обл.	1011756	670238	341518	50.95
610	113	Байкалкредобанк	2990	Иркутская обл.	1007966	1064772	-56806	-5.34
611	132	Спецстройбанк	236	Москва и обл.	997033	951377	45656	4.8
612	168	Московский Национальный Инвестиционный Банк	3181	Москва и обл.	982876	773140	209736	27.13
613	132	Первоуральскбанк	965	Свердловская обл.	981480	945003	36477	3.86
614	182	Кузбассхимбанк	2868	Кемеровская обл.	960603	709962	250641	35.3
615	89	Севзапинвестпромбанк	2152	Санкт-Петербург и обл.	954616	1196790	-242174	-20.24
616	63	Си Ди Би Банк	3339	Краснодарский край	946968	1322664	-375696	-28.4
617	183	Ресурс-Траст	3122	Москва и обл.	933987	690773	243214	35.21
618	167	Классик Эконом Банк	3298	Северная Осетия — Алания	929326	746658	182668	24.46
619	164	Акция	927	Ивановская обл.	924648	761914	162734	21.36
620	57	Объединенный Банк Республики	1016	Чувашия	924142	1338018	-413876	-30.93
621	128	Вакобанк	1291	Псковская обл.	923446	930990	-7544	-0.81
622	100	Центрально-Азиатский	3037	Хакасия	900669	1067529	-166860	-15.63
623	242	Русский Финансовый Альянс	2035	Москва и обл.	900049	427916	472133	110.33
624	192	Майский	1673	Кабардино-Балкария	891186	598348	292838	48.94
625	76	Тексбанк	2756	Карачаево-Черкесия	884564	1215771	-331207	-27.24
626	21	Новый Век	3417	Москва и обл.	882328	1534108	-651780	-42.49
627	-64	Эльбин	2267	Дагестан	867839	2222372	-1354533	-60.95
628	161	Славянбанк	804	Новгородская обл.	861242	728697	132545	18.19
629	248	Народный Инвестиционный Банк	2876	Самарская обл.	819982	370236	449746	121.48
630	59	Флора-Москва	533	Москва и обл.	818891	1267815	-448924	-35.41
631	242	Вестинтербанк	3398	Москва и обл.	813385	399589	413796	103.56
632	144	Прохладный	874	Кабардино-Балкария	806395	783001	23394	2.99
633	242	Межрегиональный Банк Реконструкции	2620	Москва и обл.	806272	374465	431807	115.31
634	112	Жилстройбанк	2769	Москва и обл.	803677	940528	-136851	-14.55
635	156	Народный Земельно-Промышленный Банк	2873	Алтайский край	793186	723348	69838	9.65
636	138	РусьРегионБанк	685	Москва и обл.	763781	793374	-29593	-3.73
637	197	Стандарт-Кредит	841	Адыгея	761762	543770	217992	40.09
638	-125	Уралприватбанк	153	Свердловская обл.	759717	2718771	-1959054	-72.06
639	97	Анелик РУ	3443	Москва и обл.	751714	984017	-232303	-23.61
640	120	Русский Банк Сбережений	779	Ставропольский край	749660	884774	-135114	-15.27
641	61	Расчетный Дом	3350	Москва и обл.	720587	1200047	-479460	-39.95
642	109	Геобанк	2027	Москва и обл.	704121	924536	-220415	-23.84
643	92	Турбобанк	3203	Санкт-Петербург и обл.	688170	995681	-307511	-30.88
644	135	Балаково-Банк	444	Саратовская обл.	679778	775428	-95650	-12.34
645	213	РИТЦ Банк	2677	Москва и обл.	666891	457695	209196	45.71
646	225	АлтайБизнес-Банк	2388	Алтайский край	656709	408086	248623	60.92
647	186	Банк РСИ	3415	Москва и обл.	655093	543943	111150	20.43
648	174	Гефест	1046	Тверская обл.	650068	581138	68930	11.86
649	128	Прокоммерцбанк	2996	Москва и обл.	616816	778854	-162038	-20.8
650	245	Терра	3476	Москва и обл.	610465	286209	324256	113.29
651	150	Холдинвестбанк	2837	Москва и обл.	604011	679178	-75167	-11.07
652	-33	Новокиб	1747	Кемеровская обл.	603630	1763777	-1160147	-65.78
653	217	ВРБ Москва	3499	Москва и обл.	600586	409841	190745	46.54
654	166	Азия Банк	3183	Москва и обл.	596088	582593	13495	2.32
655	228	АвтоКредитБанк	1973	Татарстан	595849	349097	246752	70.68
656	139	Лидер	3304	Москва и обл.	582735	711193	-128458	-18.06
657	173	СМБ-Банк	3504	Санкт-Петербург и обл.	582081	555427	26654	4.8
658	177	Энтузиастбанк	3048	Москва и обл.	561023	537901	23122	4.3
659	127	Башпромбанк	1006	Башкортостан	525778	743703	-217925	-29.3
660	186	Иронбанк	1724	Москва и обл.	520368	497480	22888	4.6
661	144	Народный Банк Республики Тыва	1309	Тыва	516824	668810	-151986	-22.72
662	-102	Международный Расчетный Банк	3028	Москва и обл.	513357	2246312	-1732955	-77.15
663	189	Дружба	990	Тюменская обл.	503779	478289	25490	5.33
664	-46	Интеркоопбанк	2803	Москва и обл.	502972	1769649	-1266677	-71.58
665	207	Логос	3233	Москва и обл.	497238	400257	96981	24.23
666	179	МВС Банк	2407	Дагестан	488250	497694	-9444	-1.9
667	165	Кредо Финанс	793	Дагестан	488238	545986	-57748	-10.58
668	160	АББ	2937	Москва и обл.	486412	557772	-71360	-12.79
669	158	Европейский Стандарт	3200	Кабардино-Балкария	486282	561442	-75160	-13.39
670	169	Стар Альянс	3433	Москва и обл.	473331	527234	-53903	-10.22
671	138	Эко-Инвест	3116	Москва и обл.	464682	647046	-182364	-28.18
672	230	Берейт	3505	Санкт-Петербург и обл.	453604	231935	221669	95.57
673	215	Таганрогбанк	3136	Ростовская обл.	438504	318383	120121	37.73
674	173	Алжан	2491	Дагестан	436091	495734	-59643	-12.03
675	207	ГРиС-Банк	1928	Ставропольский край	434826	351887	82939	23.57
676	209	Альтернатива	3452	Москва и обл.	426554	325978	100576	30.85
677	130	Промсвязьинвест	2761	Дагестан	416824	662693	-245869	-37.1
678	215	Информпрогресс	2166	Москва и обл.	415298	287843	127455	44.28
679	68	Тульский Расчетный Центр	3380	Тульская обл.	405742	940383	-534641	-56.85
680	194	Рента-Банк	3095	Москва и обл.	402806	380200	22606	5.95
681	185	Континенталь	3184	Ставропольский край	396869	427819	-30950	-7.23
682	247	РИБ	2749	Москва и обл.	388737	62960	325777	517.43
683	-147	Банк Сберегательно-кредитного сервиса	3224	Москва и обл.	385835	2463396	-2077561	-84.34
684	216	Лэнд-Банк	1478	Москва и обл.	378316	240312	138004	57.43
685		Монета.ру	3508	Марий Эл	365359			
686	75	ОЛМА-Банк	3250	Москва и обл.	364502	880828	-516326	-58.62
687	218	Рунэтбанк	2829	Москва и обл.	358944	224079	134865	60.19
688	213	Тайдон	2085	Кемеровская обл.	356943	235127	121816	51.81
689	-163	Национальный Банк Сбережений	1949	Ивановская обл.	354638	2562036	-2207398	-86.16
690	163	НКБ	2942	Москва и обл.	348164	476508	-128344	-26.93
691	217	ФФИН Банк (бывш. Охабанк)	1143	Сахалинская обл.	341722	213811	127911	59.82
692	221	Бринкс	3486	Москва и обл.	336866	153167	183699	119.93
693		Северстройбанк	3507	Вологодская обл.	323114			
694	-70	Нарат	1902	Саратовская обл.	307405	1719533	-1412128	-82.12
695	-5	Приполярком	507	Тюменская обл.	271335	1259493	-988158	-78.46
696		Универсальная электронная карта	3524	Москва и обл.	265405			
697	197	Русское Финансовое Общество	3427	Москва и обл.	237600	287257	-49657	-17.29
698	206	Майма	1037	Москва и обл.	226153	227958	-1805	-0.79
699	193	Расчетная Палата СВМБ	3324	Самарская обл.	225891	295821	-69930	-23.64
700	197	Континент Финанс	149	Москва и обл.	222793	271566	-48773	-17.96
701	179	Сетевая Расчетная Палата	3332	Татарстан	217565	356732	-139167	-39.01
702	197	Красноярский Краевой Расчетный Центр	3483	Красноярский край	215896	246255	-30359	-12.33
703	225	Инновационный Расчетный Центр	3447	Москва и обл.	193905	67087	126818	189.04
704	210	Интеррасчет	1618	Москва и обл.	187041	147116	39925	27.14
705		Электронный платежный сервис	3509	Москва и обл.	186653			
706		Деньги.Мэйл.Ру	3511	Москва и обл.	180888			
707	202	Петербургский Расчетный Центр	3306	Санкт-Петербург и обл.	161218	210295	-49077	-23.34
708		Единая касса	3512	Москва и обл.	143407			
709	209	Фидбэк	3502	Москва и обл.	129947	116712	13235	11.34
710		НКО «МОБИ.Деньги»	3523	Москва и обл.	101768			
711	212	Вест	2605	Москва и обл.	100796	97059	3737	3.85
712	199	КредитАльянс	3472	Вологодская обл.	94979	179386	-84407	-47.05
713	136	Банковские Информационные Технологии	3318	Тульская обл.	78262	488790	-410528	-83.99
714	201	Умут	2435	Дагестан	75326	139590	-64264	-46.04
715	209	Платежный Клиринговый Дом	3343	Москва и обл.	65132	93255	-28123	-30.16
716	205	Сергиево-Посадская Расчетная Палата	384	Москва и обл.	55882	102525	-46643	-45.49
717		Премиум	3514	Москва и обл.	51335			
718	212	Транзит	2688	Дагестан	41519	39282	2237	5.69
719		21 Век	3309	Санкт-Петербург и обл.	27256			
720	219	АРБ-Инкасс	3353	Москва и обл.	17856	2969	14887	501.41
721	212	Частный Расчетно-Кассовый Центр	3420	Москва и обл.	13992	25768	-11776	-45.7
722	216	Клиринговый Дом	3430	Санкт-Петербург и обл.	4318	4125	193	4.68
