Позиция в рейтинге	Изменение позиции в рейтинге	Название банка	Номер лицензии	Регион регистрации	Декабрь, 2015, тыс. рублей	Январь, 2014, тыс. рублей	Изменение, тыс. рублей	Изменение, %
1	0	Сбербанк России	1481	Москва и обл.	22433146804	16730027366	5703119438	34.09
2	0	ВТБ	1000	Санкт-Петербург и обл.	8742464567	5277158336	3465306231	65.67
3	0	Газпромбанк	354	Москва и обл.	4984239100	3622276552	1361962548	37.6
4	0	ВТБ 24	1623	Москва и обл.	2873642255	2100686266	772955989	36.8
5	3	ФК Открытие	2209	Москва и обл.	2813360795	965044832	1848315963	191.53
6	-1	Россельхозбанк	3349	Москва и обл.	2551779006	1915951035	635827971	33.19
7	0	Альфа-Банк	1326	Москва и обл.	2166341765	1562124365	604217400	38.68
8	-2	Банк Москвы	2748	Москва и обл.	1753618069	1828292759	-74674690	-4.08
9	9	Национальный Клиринговый Центр	3466	Москва и обл.	1397028289	386777212	1010251077	261.2
10	-1	ЮниКредит Банк	1	Москва и обл.	1320713756	926606774	394106982	42.53
11	-1	Промсвязьбанк	3251	Москва и обл.	1221401758	752662475	468739283	62.28
12	1	Московский Кредитный Банк	1978	Москва и обл.	1113736506	463414118	650322388	140.33
13	-2	Росбанк	2272	Москва и обл.	885949682	736292644	149657038	20.33
14	-2	Райффайзенбанк	3292	Москва и обл.	874085221	712061162	162024059	22.75
15	18	Бинбанк	2562	Москва и обл.	756341388	212410850	543930538	256.07
16	-1	Россия	328	Санкт-Петербург и обл.	558480227	418037106	140443121	33.6
17	-3	Банк «Санкт-Петербург»	436	Санкт-Петербург и обл.	549187807	447067129	102120678	22.84
18	1	Ханты-Мансийский банк Открытие	1971	Москва и обл.	511498142	377588258	133909884	35.46
19	27	Совкомбанк	963	Костромская обл.	491838800	130913145	360925655	275.7
20	0	Ак Барс	2590	Татарстан	488877251	369547856	119329395	32.29
21	65	Московский Областной Банк	1751	Москва и обл.	464808093	61691879	403116214	653.43
22	-6	Русский Стандарт	2289	Москва и обл.	460563326	400349567	60213759	15.04
23	-2	Ситибанк	2557	Москва и обл.	419809025	368811697	50997328	13.83
24	6	ИНГ Банк	2495	Москва и обл.	402937298	235368484	167568814	71.19
25	54	Рост Банк	2888	Москва и обл.	383248497	69487949	313760548	451.53
26	-3	Связь-Банк	1470	Москва и обл.	369750955	352251341	17499614	4.97
27	-2	Нордеа Банк	3016	Москва и обл.	369124223	278160968	90963255	32.7
28	4	Национальный Банк «Траст»	3279	Москва и обл.	347406759	221942704	125464055	56.53
29	6	Уральский Банк Реконструкции и Развития	429	Свердловская обл.	346364159	207063585	139300574	67.27
30	-6	МДМ Банк	323	Москва и обл.	341635505	334130788	7504717	2.25
31	11	СМП Банк	3368	Москва и обл.	339534034	155807405	183726629	117.92
32	60	Югра	880	Ханты-Мансийский АО — Югра	327614178	55278093	272336085	492.67
33	-7	Глобэкс	1942	Москва и обл.	284040902	265305884	18735018	7.06
34	-7	Зенит	3255	Москва и обл.	276777867	258313361	18464506	7.15
35	33	Всероссийский Банк Развития Регионов	3287	Москва и обл.	276530892	86824443	189706449	218.49
36	2	Новикомбанк	2546	Москва и обл.	275293911	173077891	102216020	59.06
37	3	Внешпромбанк	3261	Москва и обл.	274902436	163139873	111762563	68.51
38	-16	Хоум Кредит Банк	316	Москва и обл.	266352218	366989663	-100637445	-27.42
39	14	Абсолют Банк	2306	Москва и обл.	263012461	118471689	144540772	122
40	-12	Восточный Экспресс Банк	1460	Амурская обл.	226081496	252605333	-26523837	-10.5
41	2	Транскапиталбанк (ТКБ)	2210	Москва и обл.	223926661	143726121	80200540	55.8
42	-6	Московский Индустриальный Банк	912	Москва и обл.	219298948	201142624	18156324	9.03
43	-12	Возрождение	1439	Москва и обл.	217271750	223571868	-6300118	-2.82
44	12	Российский Капитал	2312	Москва и обл.	216520126	115273070	101247056	87.83
45	4	Татфондбанк	3058	Татарстан	201896350	127244422	74651928	58.67
46	14	Пересвет	2110	Москва и обл.	173689535	103225230	70464305	68.26
47	-8	ОТП Банк	2766	Москва и обл.	170545308	172558034	-2012726	-1.17
48	-11	МТС Банк	2268	Москва и обл.	165189870	189190779	-24000909	-12.69
49	-8	Кредит Европа Банк	3311	Москва и обл.	160362358	161086412	-724054	-0.45
50	-2	РосЕвроБанк	3137	Москва и обл.	157642303	129139704	28502599	22.07
51	10	ДельтаКредит	3338	Москва и обл.	154603293	99318001	55285292	55.66
52	17	Национальный Расчетный Депозитарий	3294	Москва и обл.	152226739	85680342	66546397	77.67
53	-6	МСП Банк	3340	Москва и обл.	151174289	130454519	20719770	15.88
54	-2	Азиатско-Тихоокеанский Банк	1810	Амурская обл.	149712338	120286448	29425890	24.46
55	2	Тинькофф Банк	2673	Москва и обл.	147558418	113486909	34071509	30.02
56	-2	Ренессанс Кредит	3354	Москва и обл.	146452707	118263004	28189703	23.84
57	-7	Росгосстрах Банк	3073	Москва и обл.	139433405	126937731	12495674	9.84
58	0	Авангард	2879	Москва и обл.	138309498	109564368	28745130	26.24
59	45	Экспресс-Волга	3085	Саратовская обл.	127934576	43566075	84368501	193.66
60	25	Сургутнефтегазбанк	588	Ханты-Мансийский АО — Югра	124621375	61717562	62903813	101.92
61	-10	Инвестторгбанк	2763	Москва и обл.	124351866	124645642	-293776	-0.24
62	-17	СКБ-Банк	705	Свердловская обл.	123055317	132220446	-9165129	-6.93
63	20	Международный Финансовый Клуб	2618	Москва и обл.	109054367	64850799	44203568	68.16
64	-9	Русфинанс Банк	1792	Самарская обл.	107382590	117279995	-9897405	-8.44
65	0	ЦентроКредит	121	Москва и обл.	105749132	91249235	14499897	15.89
66	18	Сетелем Банк	2168	Москва и обл.	102941708	62537247	40404461	64.61
67	-5	Запсибкомбанк	918	Тюменская обл.	101284015	97761659	3522356	3.6
68	29	Интеркоммерц Банк	1657	Москва и обл.	101183817	49644457	51539360	103.82
69	-6	БНП Париба Банк	3407	Москва и обл.	101157539	97600228	3557311	3.64
70	29	Креди Агриколь КИБ	1680	Санкт-Петербург и обл.	99069353	49084397	49984956	101.83
71	3	Балтийский Банк	128	Санкт-Петербург и обл.	97386906	78000020	19386886	24.85
72	-5	Союз	2307	Москва и обл.	92553232	88368451	4184781	4.74
73	-3	Локо-Банк	2707	Москва и обл.	92227894	81647121	10580773	12.96
74	-8	Банк БФА	3038	Санкт-Петербург и обл.	89467395	88460492	1006903	1.14
75	-2	Центр-инвест	2225	Ростовская обл.	89213336	78033818	11179518	14.33
76	30	РосинтерБанк	226	Москва и обл.	88805929	43044973	45760956	106.31
77	-33	Дойче Банк	3328	Москва и обл.	86758352	142772744	-56014392	-39.23
78	13	Бинбанк кредитные карты	2827	Москва и обл.	81251914	55727921	25523993	45.8
79	22	Таврический	2304	Санкт-Петербург и обл.	79711638	47660293	32051345	67.25
80	59	Банк Финсервис	3388	Москва и обл.	75121926	30577498	44544428	145.68
81	64	Военно-Промышленный Банк	3065	Москва и обл.	73672261	28794109	44878152	155.86
82	-5	Банк Интеза	2216	Москва и обл.	73568451	70659500	2908951	4.12
83	52	Лето Банк	650	Москва и обл.	72211281	31141656	41069625	131.88
84	4	Эйч-Эс-Би-Си Банк (HSBC)	3290	Москва и обл.	71604307	58953818	12650489	21.46
85	77	АйСиБиСи Банк	3475	Москва и обл.	67242735	23966681	43276054	180.57
86	35	БФГ-Кредит	3068	Москва и обл.	65593923	36616463	28977460	79.14
87	-7	Металлинвестбанк	2440	Москва и обл.	65108438	68536319	-3427881	-5
88	-10	Юниаструм Банк	2771	Москва и обл.	64389462	70012674	-5623212	-8.03
89	11	Экспобанк	2998	Москва и обл.	64225502	48085710	16139792	33.56
90	0	Кубань Кредит	2518	Краснодарский край	63121464	57080788	6040676	10.58
91	23	Аверс	415	Татарстан	61242389	38043727	23198662	60.98
92	514	Российский Национальный Коммерческий Банк	1354	Симферополь	59657999	1930058	57727941	2991.00
93	39	Образование	1521	Москва и обл.	59496856	32375064	27121792	83.77
94	-13	Балтинвестбанк	3176	Санкт-Петербург и обл.	55956172	66102193	-10146021	-15.35
95	33	Росэнергобанк	2211	Москва и обл.	55509246	33451735	22057511	65.94
96	137	Бэнк оф Чайна	2309	Москва и обл.	55508094	13471520	42036574	312.04
97	-2	Международный Банк Санкт-Петербурга (МБСП)	197	Санкт-Петербург и обл.	53566090	53351088	215002	0.4
98	36	Финпромбанк (ФПБ Банк)	2157	Москва и обл.	51505239	31286946	20218293	64.62
99	-5	Национальный Стандарт	3421	Москва и обл.	50892858	53366591	-2473733	-4.64
100	2	Межтопэнергобанк	2956	Москва и обл.	49962227	46937513	3024714	6.44
101	-5	Тойота Банк	3470	Москва и обл.	49878296	52136213	-2257917	-4.33
102	285	РН Банк	170	Москва и обл.	48401349	5483844	42917505	782.62
103	-16	Первобанк	3461	Самарская обл.	48267827	59159943	-10892116	-18.41
104	8	Фора-Банк	1885	Москва и обл.	47724048	38899721	8824327	22.68
105	3	Коммерцбанк (Евразия)	3333	Москва и обл.	47678680	42323804	5354876	12.65
106	7	СДМ-Банк	1637	Москва и обл.	47658112	38112600	9545512	25.05
107	61	БКС — Инвестиционный Банк	101	Новосибирская обл.	46704165	22228832	24475333	110.11
108	-10	Меткомбанк (Каменск-Уральский)	2443	Свердловская обл.	46001656	49211746	-3210090	-6.52
109	99	Газэнергобанк	3252	Калужская обл.	45422607	16256188	29166419	179.42
110	38	Сумитомо Мицуи	3494	Москва и обл.	45383679	28317697	17065982	60.27
111	26	Банк «МБА-Москва»	3395	Москва и обл.	45259943	30918643	14341300	46.38
112	32	ББР Банк	2929	Москва и обл.	44244585	29272931	14971654	51.15
113	12	Интерпрогрессбанк	600	Москва и обл.	43524275	35314676	8209599	23.25
114	129	Росэксимбанк	2790	Москва и обл.	43347831	12483097	30864734	247.25
115	-5	Примсоцбанк	2733	Приморский край	42378648	39706426	2672222	6.73
116	2	Челиндбанк	485	Челябинская обл.	42296224	36895817	5400407	14.64
117	-1	Челябинвестбанк	493	Челябинская обл.	41523327	37563209	3960118	10.54
118	-25	Еврофинанс Моснарбанк	2402	Москва и обл.	40506119	54384932	-13878813	-25.52
119	36	Первый Чешско-Российский Банк	3291	Москва и обл.	39671737	25207455	14464282	57.38
120	7	Левобережный	1343	Новосибирская обл.	39463214	33640562	5822652	17.31
121	-16	Меткомбанк (Череповец)	901	Вологодская обл.	38586489	43266319	-4679830	-10.82
122	-5	Кольцо Урала	65	Свердловская обл.	38152691	37273559	879132	2.36
123	-16	НС Банк	3124	Москва и обл.	37195488	42607300	-5411812	-12.7
124	-2	Саровбизнесбанк	2048	Нижегородская обл.	36251912	36410267	-158355	-0.43
125	4	Интерпромбанк	3266	Москва и обл.	36169587	33233088	2936499	8.84
126	12	Фольксваген Банк Рус	3500	Москва и обл.	36107718	30871664	5236054	16.96
127	-7	Русский Международный Банк	3123	Москва и обл.	35266316	36654256	-1387940	-3.79
128	-5	Советский	558	Санкт-Петербург и обл.	35250592	36122767	-872175	-2.41
129	17	Русстройбанк	3205	Москва и обл.	33893169	28491175	5401994	18.96
130	56	Натиксис Банк	3390	Москва и обл.	32853934	20048872	12805062	63.87
131	51	Держава	2738	Москва и обл.	32075114	20319897	11755217	57.85
132	28	М2М Прайвет Банк	1414	Москва и обл.	31904419	24245448	7658971	31.59
133	8	Кедр	1574	Красноярский край	31547376	29907622	1639754	5.48
134	2	Банк СГБ	2816	Вологодская обл.	31312164	31014929	297235	0.96
135	-46	Собинбанк	1317	Москва и обл.	31244778	58355817	-27111039	-46.46
136	20	Приморье	3001	Приморский край	30705340	25177868	5527472	21.95
137	24	Кредит Урал Банк	2584	Челябинская обл.	30445313	24130284	6315029	26.17
138	66	Тольяттихимбанк	2507	Самарская обл.	30315516	17214144	13101372	76.11
139	30	Мерседес-Бенц Банк Рус	3473	Москва и обл.	29727447	21981503	7745944	35.24
140	-21	БыстроБанк	1745	Удмуртия	29712502	36807600	-7095098	-19.28
141	34	Интехбанк	2705	Татарстан	29346043	21105485	8240558	39.04
142	1	Дальневосточный Банк	843	Приморский край	29323206	29451731	-128525	-0.44
143	85	ОФК Банк	2270	Москва и обл.	29048175	14037442	15010733	106.93
144	34	Солидарность (Самара)	554	Самарская обл.	28750476	20785681	7964795	38.32
145	36	АйМаниБанк	1975	Москва и обл.	28490801	20533051	7957750	38.76
146	59	Московское Ипотечное Агентство	3344	Москва и обл.	28376576	17129877	11246699	65.66
147	-17	Газбанк	2316	Самарская обл.	28091508	32679412	-4587904	-14.04
148	78	Объединенный Капитал	2611	Санкт-Петербург и обл.	27721751	14207586	13514165	95.12
149	159	Инвестиционный Республиканский Банк	2571	Москва и обл.	27502928	7971571	19531357	245.01
150	8	Девон-Кредит	1972	Татарстан	27387771	24945270	2442501	9.79
151	169	Ишбанк	2867	Москва и обл.	27148006	7662544	19485462	254.29
152	69	Плюс Банк	1189	Москва и обл.	26650277	14763602	11886675	80.51
153	0	Акибанк	2587	Татарстан	26607584	25893014	714570	2.76
154	12	Москоммерцбанк	3365	Москва и обл.	26260376	22500717	3759659	16.71
155	32	АктивКапитал Банк	3006	Самарская обл.	25967510	20020678	5946832	29.7
156	-6	Липецккомбанк	1242	Липецкая обл.	25605653	27126231	-1520578	-5.61
157	-48	Королевский Банк Шотландии	2594	Москва и обл.	25218457	41988811	-16770354	-39.94
158	21	Тимер Банк	1581	Татарстан	25215968	20748937	4467031	21.53
159	26	Легион	3117	Москва и обл.	25019364	20162700	4856664	24.09
160	-29	Агропромкредит	2880	Москва и обл.	24977236	32448394	-7471158	-23.02
161	-7	Уральский Финансовый Дом	249	Пермская обл.	24643264	25770969	-1127705	-4.38
162	190	Чайна Констракшн	3515	Москва и обл.	24386473	6408000	17978473	280.56
163	-12	Региональный Кредит	1927	Костромская обл.	24119063	26782998	-2663935	-9.95
164	147	Генбанк	2490	Москва и обл.	24047811	7906303	16141508	204.16
165	8	Алмазэргиэнбанк	2602	Саха (Якутия)	23722139	21294395	2427744	11.4
166	18	Морской Банк	77	Москва и обл.	23470795	20214905	3255890	16.11
167	-10	Платежный Центр	3166	Новосибирская обл.	22595297	24955071	-2359774	-9.46
168	55	СтарБанк	548	Москва и обл.	22542033	14723627	7818406	53.1
169	23	Энерготрансбанк	1307	Калининградская обл.	22457903	18838271	3619632	19.21
170	19	Ланта-Банк	1920	Москва и обл.	22210505	19912870	2297635	11.54
171	-12	Альта-Банк	2269	Москва и обл.	22109373	24311157	-2201784	-9.06
172	93	СЭБ Банк	3235	Санкт-Петербург и обл.	21844262	10788300	11055962	102.48
173	4	Спурт Банк	2207	Татарстан	21729708	20934923	794785	3.8
174	-7	Аресбанк	2914	Москва и обл.	21250792	22291468	-1040676	-4.67
175	13	ФИА-Банк	2542	Самарская обл.	20923758	20000432	923326	4.62
176	30	НБД-Банк	1966	Нижегородская обл.	20707831	17035473	3672358	21.56
177	89	Башкомснаббанк	1398	Башкортостан	20586166	10662479	9923687	93.07
178	15	Энергобанк	67	Татарстан	20537611	18497772	2039839	11.03
179	46	Нацинвестпромбанк	3077	Москва и обл.	20187058	14438455	5748603	39.81
180		Морган Стэнли Банк	3456	Москва и обл.	19892165			
181	55	Социнвестбанк	1132	Башкортостан	19551838	13199706	6352132	48.12
182	18	Курскпромбанк	735	Курская обл.	19453119	17363945	2089174	12.03
183	51	ВУЗ-Банк	1557	Свердловская обл.	19393559	13348626	6044933	45.29
184	-19	БМВ Банк	3482	Москва и обл.	18849048	23394432	-4545384	-19.43
185	39	Рублев	3098	Москва и обл.	18438727	14569410	3869317	26.56
186	-60	Банк Кредит Свисс	2494	Москва и обл.	18382752	33773415	-15390663	-45.57
187	55	Денизбанк Москва	3330	Москва и обл.	18122511	12763699	5358812	41.98
188	9	Развитие-Столица	3013	Москва и обл.	18114870	17660500	454370	2.57
189	-15	Алеф-Банк	2119	Москва и обл.	17602440	21165497	-3563057	-16.83
190	106	Тройка-Д Банк	3431	Москва и обл.	17445124	8462054	8983070	106.16
191	31	Расчетно-Кредитный Банк	103	Москва и обл.	17326725	14726248	2600477	17.66
192	47	НК Банк	2755	Москва и обл.	17293046	13036430	4256616	32.65
193	20	Хлынов	254	Кировская обл.	17115331	15473819	1641512	10.61
194	57	Данске Банк	3307	Санкт-Петербург и обл.	17016420	11904964	5111456	42.94
195	165	Ури Банк	3479	Москва и обл.	16495687	6190145	10305542	166.48
196	109	Джей энд Ти Банк	3061	Москва и обл.	16386128	8006557	8379571	104.66
197	41	Центркомбанк	2983	Москва и обл.	16315400	13059818	3255582	24.93
198	-2	Уралтрансбанк	812	Свердловская обл.	16268903	18059366	-1790463	-9.91
199	0	Петербургский Социальный Коммерческий Банк	2551	Санкт-Петербург и обл.	15965475	17494915	-1529440	-8.74
200	59	Гарант-Инвест	2576	Москва и обл.	15846151	11022288	4823863	43.76
201	0	Форштадт	2208	Оренбургская обл.	15437483	17304353	-1866870	-10.79
202	42	Русский Ипотечный Банк	1968	Москва и обл.	15367377	12481974	2885403	23.12
203	-8	Норвик Банк	902	Кировская обл.	15312834	18188948	-2876114	-15.81
204	13	Гранд Инвест Банк	3053	Москва и обл.	15255556	15158472	97084	0.64
205	43	Росавтобанк	2767	Москва и обл.	15164035	12198485	2965550	24.31
206	-54	Национальный Резервный Банк	2170	Москва и обл.	15069713	26069436	-10999723	-42.19
207	64	Темпбанк	55	Москва и обл.	15047169	10306809	4740360	45.99
208	6	Росдорбанк	1573	Москва и обл.	14985395	15425491	-440096	-2.85
209	26	Акцепт	567	Новосибирская обл.	14932481	13291190	1641291	12.35
210	21	ТЭМБР-Банк	2764	Москва и обл.	14597257	13635263	961994	7.06
211	73	Татсоцбанк	480	Татарстан	14567837	9142556	5425281	59.34
212	15	БайкалБанк	2632	Бурятия	14106854	14182497	-75643	-0.53
213	340	Российская Финансовая Корпорация	3099	Москва и обл.	14035227	2376830	11658397	490.5
214	-23	ГПБ-Ипотека	2403	Москва и обл.	13827458	19790666	-5963208	-30.13
215	-21	Пойдем!	2534	Москва и обл.	13779409	18372966	-4593557	-25
216	44	Дил-Банк	3384	Москва и обл.	13707960	10979394	2728566	24.85
217	130	Финансовый Стандарт	1053	Москва и обл.	13456822	6681791	6775031	101.4
218	50	Прио-Внешторгбанк	212	Рязанская обл.	13008951	10559252	2449699	23.2
219	81	Агросоюз	1459	Москва и обл.	12992660	8213788	4778872	58.18
220	47	Нефтяной Альянс	2859	Москва и обл.	12900760	10609306	2291454	21.6
221	57	Международный Акционерный Банк	1987	Москва и обл.	12713317	9679195	3034122	31.35
222	25	Солидарность (Москва)	1555	Москва и обл.	12514847	12226419	288428	2.36
223	174	Инбанк	1829	Москва и обл.	12490582	5296277	7194305	135.84
224	179	Объединенный Кредитный Банк	1118	Ярославская обл.	12365067	5069164	7295903	143.93
225	54	Русьуниверсалбанк	3293	Москва и обл.	12348433	9540050	2808383	29.44
226	38	Солид Банк	1329	Камчатская обл.	12127937	10821564	1306373	12.07
227	61	КС Банк	1752	Мордовия	11599914	9001115	2598799	28.87
228	-21	Первомайский	518	Краснодарский край	11507303	16991507	-5484204	-32.28
229	74	Нижневолжский Коммерческий Банк	931	Саратовская обл.	11430471	8089267	3341204	41.3
230	44	Стратегия	2801	Москва и обл.	11425221	10153582	1271639	12.52
231	104	Русский Торговый Банк	2842	Москва и обл.	11406349	7053646	4352703	61.71
232	94	Ренессанс	1939	Москва и обл.	11346975	7339047	4007928	54.61
233	-15	Национальная Факторинговая Компания	3437	Москва и обл.	11261621	15145851	-3884230	-25.65
234	24	Автоторгбанк	2776	Москва и обл.	11234709	11219850	14859	0.13
235	574	Арксбанк	1868	Москва и обл.	11134937	559339	10575598	1890.73
236	82	Развитие	2729	Карачаево-Черкесия	10973888	7703236	3270652	42.46
237	38	ЕвроситиБанк	1869	Москва и обл.	10908772	9932141	976631	9.83
238	-6	СИАБ	3245	Санкт-Петербург и обл.	10807780	13540623	-2732843	-20.18
239	17	Оренбург	3269	Оренбургская обл.	10805390	11432505	-627115	-5.49
240	47	Промтрансбанк	2638	Башкортостан	10783605	9012420	1771185	19.65
241	-31	Гаранти Банк — Москва	3275	Москва и обл.	10726813	15934723	-5207910	-32.68
242	30	Банк Жилищного Финансирования	3138	Москва и обл.	10684064	10258244	425820	4.15
243	277	Кошелев-Банк	3300	Самарская обл.	10656937	2635711	8021226	304.33
244	-35	Александровский	53	Санкт-Петербург и обл.	10559753	15977953	-5418200	-33.91
245	18	Унифин	2654	Москва и обл.	10412097	10925717	-513620	-4.7
246	36	Нико-Банк	702	Оренбургская обл.	10363527	9257244	1106283	11.95
247	2	Киви Банк	2241	Москва и обл.	10227569	12150037	-1922468	-15.82
248	59	Славия	2664	Москва и обл.	10141643	7984761	2156882	27.01
249	20	Энергомашбанк	52	Санкт-Петербург и обл.	9882559	10512025	-629466	-5.99
250	81	Ассоциация	732	Нижегородская обл.	9878213	7138094	2740119	38.39
251	6	Хованский	2145	Москва и обл.	9729713	11248314	-1518601	-13.5
252	70	Ставропольпромстройбанк	1288	Ставропольский край	9580120	7535271	2044849	27.14
253	86	Новопокровский	467	Краснодарский край	9392165	6945403	2446762	35.23
254	99	Банк Казани	708	Татарстан	9363286	6355414	3007872	47.33
255	38	Кредит-Москва	5	Москва и обл.	9278911	8657658	621253	7.18
256	14	Миллениум Банк	3423	Москва и обл.	9275519	10323393	-1047874	-10.15
257	47	Япы Креди Банк Москва	2555	Москва и обл.	9220459	8038649	1181810	14.7
258	155	Финанс Бизнес Банк	520	Москва и обл.	9193031	4927508	4265523	86.57
259	42	Снежинский	1376	Челябинская обл.	9149543	8174859	974684	11.92
260	59	Ижкомбанк	646	Удмуртия	8894474	7683092	1211382	15.77
261	67	Банк БКФ	2684	Москва и обл.	8879856	7215405	1664451	23.07
262	54	Северо-Восточный Альянс	2768	Москва и обл.	8865073	7840859	1024214	13.06
263	79	Таатта	1249	Саха (Якутия)	8845172	6827963	2017209	29.54
264	77	Вокбанк	312	Нижегородская обл.	8832439	6835276	1997163	29.22
265	-12	Екатеринбург	3161	Свердловская обл.	8796759	11707107	-2910348	-24.86
266	19	Мир Бизнес Банк	3396	Москва и обл.	8784113	9089307	-305194	-3.36
267	-96	Гута-Банк	256	Москва и обл.	8652984	21687038	-13034054	-60.1
268	168	Верхневолжский	1084	Ярославская обл.	8630585	4204234	4426351	105.28
269	23	Нефтепромбанк	2156	Москва и обл.	8584044	8702267	-118223	-1.36
270	57	Московский Нефтехимический Банк	1411	Москва и обл.	8459969	7230812	1229157	17
271	-10	ЯР-Банк	3185	Москва и обл.	8458492	10975007	-2516515	-22.93
272	52	Томскпромстройбанк	1720	Томская обл.	8442573	7490011	952562	12.72
273	29	ПИР Банк	2655	Москва и обл.	8422975	8101901	321074	3.96
274	62	Юг-Инвестбанк	2772	Краснодарский край	8356750	7025902	1330848	18.94
275	-64	РусЮгбанк	2093	Волгоградская обл.	8241611	15895336	-7653725	-48.15
276	53	Альба Альянс	2593	Москва и обл.	8179879	7170110	1009769	14.08
277	35	Рускобанк	138	Санкт-Петербург и обл.	8062152	7883023	179129	2.27
278	113	Эксперт Банк	2949	Омская обл.	7900991	5475772	2425219	44.29
279	138	Современный Коммерческий Ипотечный Банк	3329	Костромская обл.	7780975	4836555	2944420	60.88
280	149	Синко-Банк	2838	Москва и обл.	7768186	4506102	3262084	72.39
281	28	Финам Банк	2799	Москва и обл.	7765804	7949376	-183572	-2.31
282	169	МС Банк Рус	2789	Москва и обл.	7631451	3836763	3794688	98.9
283	15	Белгородсоцбанк	760	Белгородская обл.	7598159	8368107	-769948	-9.2
284	33	Славянский Кредит	2960	Москва и обл.	7549773	7782929	-233156	-3
285	76	Бинбанк Тверь	777	Тверская обл.	7523907	6111659	1412248	23.11
286	-5	Углеметбанк	2997	Челябинская обл.	7521772	9322430	-1800658	-19.32
287	71	Северный Кредит	2398	Вологодская обл.	7521079	6256725	1264354	20.21
288	152	Консервативный Коммерческий Банк	1087	Астраханская обл.	7507137	4057468	3449669	85.02
289	141	Союзный	3236	Москва и обл.	7435775	4493091	2942684	65.49
290	9	Экспресс-Кредит	210	Москва и обл.	7294232	8236075	-941843	-11.44
291	89	Чувашкредитпромбанк	1280	Чувашия	7258465	5706108	1552357	27.21
292	59	Анкор Банк	889	Татарстан	7246739	6487260	759479	11.71
293	127	Риабанк	3434	Москва и обл.	7223779	4759650	2464129	51.77
294	77	Век	2299	Москва и обл.	7213831	5871673	1342158	22.86
295	191	Торговый Городской Банк	3180	Тверская обл.	7211381	3223967	3987414	123.68
296	36	Муниципальный Камчатпрофитбанк	2103	Камчатская обл.	7138784	7124693	14091	0.2
297	33	Голдман Сакс Банк	3490	Москва и обл.	7135798	7165924	-30126	-0.42
298	275	Кубаньторгбанк	478	Краснодарский край	7009508	2190546	4818962	219.99
299	90	Ю Би Эс Банк	3463	Москва и обл.	7008214	5480804	1527410	27.87
300	44	Трансстройбанк	2807	Москва и обл.	7007445	6753524	253921	3.76
301	66	Банк на Красных Воротах	2472	Москва и обл.	6916530	5957504	959026	16.1
302	63	Азия-Инвест Банк	3303	Москва и обл.	6910754	6020464	890290	14.79
303	40	Русь	704	Оренбургская обл.	6764786	6806822	-42036	-0.62
304	10	Вега-Банк	3270	Москва и обл.	6700477	7865860	-1165383	-14.82
305	41	Кузнецкбизнесбанк	1158	Кемеровская обл.	6667224	6701901	-34677	-0.52
306	88	Банк Торгового Финансирования	1982	Москва и обл.	6647149	5389531	1257618	23.33
307	61	Эл Банк	1025	Самарская обл.	6593412	5935821	657591	11.08
308	37	Бинбанк Мурманск	1276	Мурманская обл.	6591681	6726947	-135266	-2.01
309	-18	Роспромбанк	3204	Москва и обл.	6590435	8726313	-2135878	-24.48
310	54	Актив Банк	2529	Мордовия	6547498	6028670	518828	8.61
311	74	Эргобанк	2856	Москва и обл.	6546524	5526121	1020403	18.47
312	97	Русский Трастовый Банк	1139	Москва и обл.	6509501	4965428	1544073	31.1
313	203	Воронеж	654	Воронежская обл.	6499671	2758420	3741251	135.63
314	36	Новый Московский Банк	2932	Москва и обл.	6447996	6642590	-194594	-2.93
315	73	РЕСО Кредит	3450	Москва и обл.	6444090	5482216	961874	17.55
316	-40	Руснарбанк	3403	Москва и обл.	6411313	9737387	-3326074	-34.16
317	61	Нэклис-Банк	1671	Москва и обл.	6411235	5740771	670464	11.68
318	90	Кремлевский	2905	Москва и обл.	6404503	4971670	1432833	28.82
319	150	Коммерческий Индо Банк	3446	Москва и обл.	6271630	3584326	2687304	74.97
320	42	Кранбанк	2271	Ивановская обл.	6262099	6079664	182435	3
321	-81	Банк ПСА Финанс Рус	3481	Москва и обл.	6197279	12911469	-6714190	-52
322	171	Енисей	474	Красноярский край	6163263	3114872	3048391	97.87
323	99	Экси-Банк	2530	Санкт-Петербург и обл.	6126992	4702602	1424390	30.29
324	83	Банкхаус Эрбе	1717	Москва и обл.	6094503	4989911	1104592	22.14
325	-79	Объединенная Расчетная Система	3342	Москва и обл.	6015399	12251415	-6236016	-50.9
326	86	Межтрастбанк	2493	Москва и обл.	5998144	4942826	1055318	21.35
327	55	Проминвестбанк	2433	Москва и обл.	5989690	5566511	423179	7.6
328	118	Идея Банк	430	Краснодарский край	5951602	3969758	1981844	49.92
329	41	Северный Народный Банк	2721	Коми	5902967	5873305	29662	0.51
330	75	Хакасский Муниципальный Банк	1049	Хакасия	5888530	5017413	871117	17.36
331	-6	ФДБ	3071	Москва и обл.	5856032	7339164	-1483132	-20.21
332	91	Банк Оранжевый	1659	Санкт-Петербург и обл.	5854129	4642652	1211477	26.09
333	93	Нейва	1293	Свердловская обл.	5762628	4598240	1164388	25.32
334	211	Ринвестбанк	3262	Рязанская обл.	5749444	2427479	3321965	136.85
335	146	Мираф-Банк	2244	Омская обл.	5718304	3345526	2372778	70.92
336	102	Бинбанк Смоленск	1957	Смоленская обл.	5676186	4130416	1545770	37.42
337	32	Автоградбанк	1455	Татарстан	5606025	5911870	-305845	-5.17
338	106	Итуруп	2390	Сахалинская обл.	5526339	3994599	1531740	38.35
339	113	Милбанк	3256	Москва и обл.	5514438	3826901	1687537	44.1
340	81	Енисейский Объединенный Банк	2645	Красноярский край	5500513	4704161	796352	16.93
341	90	Газстройбанк	2919	Москва и обл.	5480556	4491160	989396	22.03
342	57	Мосуралбанк	2468	Москва и обл.	5462552	5264918	197634	3.75
343	115	Банк Раунд	2506	Москва и обл.	5434099	3683183	1750916	47.54
344	88	Промрегионбанк	2123	Томская обл.	5423065	4458398	964667	21.64
345	144	РТС-Банк	3401	Самарская обл.	5411133	3176637	2234496	70.34
346	31	Камский Коммерческий Банк	438	Татарстан	5337730	5757203	-419473	-7.29
347	110	Сити Инвест Банк	3194	Санкт-Петербург и обл.	5290843	3689658	1601185	43.4
348	132	НБК-Банк	3283	Москва и обл.	5254978	3376932	1878046	55.61
349	143	Владпромбанк	870	Владимирская обл.	5217975	3151613	2066362	65.57
350		Кореа Эксчендж Банк Рус	3525	Москва и обл.	5169988			
351	21	Донкомбанк	492	Ростовская обл.	5153821	5866666	-712845	-12.15
352	-31	Уралкапиталбанк	2519	Башкортостан	5129346	7580367	-2451021	-32.33
353	33	Сибсоцбанк	2015	Алтайский край	5113152	5512868	-399716	-7.25
354	27	Национальный Залоговый Банк	2944	Москва и обл.	5060130	5648423	-588293	-10.42
355	-7	Банк БЦК-Москва	3480	Москва и обл.	5032427	6676843	-1644416	-24.63
356	86	Конфидэнс Банк	970	Костромская обл.	4963766	4039684	924082	22.88
357	86	Новобанк	1352	Новгородская обл.	4955659	4036344	919315	22.78
358	87	Московский Коммерческий Банк	3172	Москва и обл.	4891539	3972829	918710	23.12
359	60	Межрегиональный промышленно-строительный банк	752	Мордовия	4890837	4782512	108325	2.27
360	40	ВостСибтранскомбанк	2731	Иркутская обл.	4812604	5205919	-393315	-7.56
361	251	Приско Капитал Банк	2537	Москва и обл.	4788554	1862070	2926484	157.16
362	85	Земский Банк	2900	Самарская обл.	4784209	3942331	841878	21.35
363	-25	Банк Инноваций и Развития	2647	Москва и обл.	4777648	6975299	-2197651	-31.51
364	34	Москва-Сити	3247	Москва и обл.	4749690	5279637	-529947	-10.04
365	19	Промэнергобанк	2728	Вологодская обл.	4688680	5542675	-853995	-15.41
366	172	Газтрансбанк	665	Адыгея	4649157	2480904	2168253	87.4
367	-4	Зенит Сочи	232	Краснодарский край	4631615	6058887	-1427272	-23.56
368	-62	Платина	2347	Москва и обл.	4630912	7998740	-3367828	-42.1
369	193	ФорБанк	2063	Москва и обл.	4630597	2322380	2308217	99.39
370	84	Заречье	817	Татарстан	4575485	3796827	778658	20.51
371	33	Банк Развития Технологий	3441	Москва и обл.	4566994	5033187	-466193	-9.26
372	3	Экономикс-Банк	2136	Москва и обл.	4560262	5782526	-1222264	-21.14
373	104	Уссури	596	Хабаровский край	4512186	3407950	1104236	32.4
374	91	Промсельхозбанк	538	Москва и обл.	4496002	3628351	867651	23.91
375	20	Европлан Банк	3052	Москва и обл.	4478921	5330572	-851651	-15.98
376	57	Кузнецкий	609	Пензенская обл.	4438072	4425172	12900	0.29
377	293	Капиталбанк	2547	Ростовская обл.	4390524	1316073	3074451	233.61
378	92	Сибирский Банк Реконструкции и Развития	1284	Тюменская обл.	4386782	3562280	824502	23.15
379	80	Финансово-Промышленный Капитал	3295	Москва и обл.	4366112	3675747	690365	18.78
380	107	Венец	524	Ульяновская обл.	4244193	3182748	1061445	33.35
381	79	Камчаткомагропромбанк	545	Камчатская обл.	4221768	3667083	554685	15.13
382	59	Роял Кредит Банк	783	Хабаровский край	4171708	4046668	125040	3.09
383	336	Прайм Финанс	2758	Санкт-Петербург и обл.	4135941	1044438	3091503	296
384		Чайнасельхозбанк	3529	Москва и обл.	4129408			
385	93	Форус Банк	3457	Нижегородская обл.	4111135	3406197	704938	20.7
386	81	Витабанк	356	Санкт-Петербург и обл.	4083034	3608434	474600	13.15
387	-11	Международный Коммерческий Банк	2524	Москва и обл.	4072170	5761523	-1689353	-29.32
388	-5	Стройлесбанк	2995	Тюменская обл.	4009010	5553187	-1544177	-27.81
389	157	Русский Национальный Банк	469	Ростовская обл.	3902794	2420299	1482495	61.25
390	12	Горбанк	2982	Санкт-Петербург и обл.	3871569	5078387	-1206818	-23.76
391	27	Крыловский	456	Краснодарский край	3854733	4819039	-964306	-20.01
392	-37	Кузнецкий Мост	2254	Москва и обл.	3846924	6300780	-2453856	-38.95
393	112	Вологжанин	1896	Вологодская обл.	3835921	2902978	932943	32.14
394	43	Интернациональный Торговый Банк	2609	Омская обл.	3832231	4197833	-365602	-8.71
395	-55	Руссобанк	2313	Москва и обл.	3804503	6841936	-3037433	-44.39
396	101	Агророс	2860	Саратовская обл.	3796118	2986569	809549	27.11
397	238	Земкомбанк	574	Ростовская обл.	3775686	1636292	2139394	130.75
398	137	МФБанк	3163	Москва и обл.	3745267	2494973	1250294	50.11
399	17	БайкалИнвестБанк	1067	Иркутская обл.	3731550	4894825	-1163275	-23.77
400	-26	Невский Банк	1068	Санкт-Петербург и обл.	3729647	5826057	-2096410	-35.98
401	118	Айви Банк	2055	Москва и обл.	3714564	2677350	1037214	38.74
402	152	Выборг-Банк	720	Санкт-Петербург и обл.	3707876	2367446	1340430	56.62
403	36	Мастер-Капитал	3011	Москва и обл.	3705583	4079662	-374079	-9.17
404	154	Объединенный Резервный Банк	937	Москва и обл.	3704698	2336200	1368498	58.58
405	270	Метрополь	1639	Москва и обл.	3675617	1294302	2381315	183.98
406	177	Евразийский Банк	969	Москва и обл.	3664450	2084902	1579548	75.76
407	61	Аксонбанк	680	Костромская обл.	3656481	3592468	64013	1.78
408	109	Инвестсоцбанк	3010	Москва и обл.	3652688	2756051	896637	32.53
409	-16	Межрегиональный Почтовый Банк	3171	Москва и обл.	3632492	5391690	-1759198	-32.63
410	164	Банкирский Дом	2928	Санкт-Петербург и обл.	3577688	2180505	1397183	64.08
411	87	Уралпромбанк	2964	Челябинская обл.	3573762	2986413	587349	19.67
412	149	Бест Эффортс Банк	435	Москва и обл.	3557080	2322903	1234177	53.13
413	60	Живаго-Банк	2065	Рязанская обл.	3556737	3476240	80497	2.32
414	145	Донхлеббанк	2285	Ростовская обл.	3545470	2325872	1219598	52.44
415	195	Московско-Парижский Банк	2646	Москва и обл.	3538981	1897444	1641537	86.51
416	11	Веста	2368	Москва и обл.	3537304	4593569	-1056265	-22.99
417	85	Зираат Банк	2559	Москва и обл.	3527564	2937616	589948	20.08
418	-64	Уральский Межрегиональный Банк	1441	Свердловская обл.	3513042	6301009	-2787967	-44.25
419		Н-Банк	3493	Москва и обл.	3511307			
420	128	Юнистрим	3467	Москва и обл.	3499389	2404299	1095090	45.55
421	43	Наш Дом	3296	Москва и обл.	3470207	3632655	-162448	-4.47
422	127	Констанс-Банк	2228	Санкт-Петербург и обл.	3459651	2403710	1055941	43.93
423	119	Кубанский Универсальный Банк	2898	Краснодарский край	3454653	2452729	1001924	40.85
424	39	Новое Время	3492	Москва и обл.	3449432	3643875	-194443	-5.34
425	58	Смартбанк	3408	Москва и обл.	3414201	3304981	109220	3.3
426	285	Мико-Банк	3195	Москва и обл.	3381095	1086106	2294989	211.3
427	67	Рапида	3371	Москва и обл.	3350860	3075590	275270	8.95
428	6	Ермак	1809	Ханты-Мансийский АО — Югра	3319390	4419899	-1100509	-24.9
429	70	Росбизнесбанк	1405	Москва и обл.	3316004	2971475	344529	11.59
430	374	Центрально-Европейский Банк	2670	Москва и обл.	3308618	594437	2714181	456.6
431	171	Сибэс	208	Омская обл.	3307117	1977093	1330024	67.27
432	86	Крокус-Банк	2682	Москва и обл.	3304521	2706132	598389	22.11
433	57	Народный Доверительный Банк	2374	Москва и обл.	3302078	3162452	139626	4.42
434	66	Нокссбанк	3202	Волгоградская обл.	3286819	2956831	329988	11.16
435	26	Алтайкапиталбанк	2659	Алтайский край	3269162	3658947	-389785	-10.65
436	13	Долинск	857	Сахалинская обл.	3257561	3889077	-631516	-16.24
437	86	Братский АНКБ	1144	Иркутская обл.	3247262	2622271	624991	23.83
438	176	Ростфинанс	481	Ростовская обл.	3220924	1845470	1375454	74.53
439	-166	Международный Банк Развития	2704	Москва и обл.	3205280	10171471	-6966191	-68.49
440	8	Интеркредит	3047	Москва и обл.	3188758	3927671	-738913	-18.81
441	-35	Церих	3278	Орловская обл.	3187906	4992027	-1804121	-36.14
442	62	Мегаполис	3265	Чувашия	3182459	2905939	276520	9.52
443	79	Иваново	1763	Ивановская обл.	3162815	2623529	539286	20.56
444	211	Региональный Коммерческий Банк	836	Ульяновская обл.	3153258	1470126	1683132	114.49
445	31	Океан Банк	1697	Москва и обл.	3128233	3415240	-287007	-8.4
446	20	Элита	1399	Калужская обл.	3114124	3622895	-508771	-14.04
447	166	Яндекс.Деньги	3510	Россия	3113796	1856100	1257696	67.76
448	23	Лайтбанк	3177	Москва и обл.	3104832	3508844	-404012	-11.51
449	255	Банк Премьер Кредит	1663	Москва и обл.	3076655	1138498	1938157	170.24
450	-22	Оргбанк	3312	Москва и обл.	3070857	4564156	-1493299	-32.72
451	118	Аспект	608	Москва и обл.	3035050	2246199	788851	35.12
452	247	Первый Клиентский Банк	3436	Москва и обл.	2991255	1159167	1832088	158.05
453	74	Радиотехбанк	1166	Нижегородская обл.	2966138	2578003	388135	15.06
454	20	Тамбовкредитпромбанк	1312	Тамбовская обл.	2901765	3424069	-522304	-15.25
455	7	РБА	3413	Москва и обл.	2888258	3654630	-766372	-20.97
456	29	Интерактивный Банк	3378	Москва и обл.	2883744	3289140	-405396	-12.33
457	309	Банк ВВБ	1093	Севастополь	2859686	768185	2091501	272.27
458	-99	Кроссинвестбанк	2849	Москва и обл.	2842938	6198702	-3355764	-54.14
459	-3	Евроальянс	1781	Ивановская обл.	2834395	3736236	-901841	-24.14
460	125	Межбанковский Кредитный Союз	3242	Москва и обл.	2801085	2083141	717944	34.46
461	385	Еврокапитал-Альянс	2672	Ярославская обл.	2786919	400997	2385922	595
462	-38	Банк Экономический Союз	2798	Москва и обл.	2777152	4631030	-1853878	-40.03
463	109	Заубер Банк	1614	Санкт-Петербург и обл.	2767244	2200656	566588	25.75
464	104	Кросна-Банк	2607	Москва и обл.	2756487	2265885	490602	21.65
465	31	Костромаселькомбанк	1115	Костромская обл.	2755517	3060568	-305051	-9.97
466	29	ЕвроАксис Банк	3273	Москва и обл.	2710901	3073850	-362949	-11.81
467	66	Богородский	1277	Нижегородская обл.	2641702	2513458	128244	5.1
468	56	Система	2846	Москва и обл.	2628570	2621172	7398	0.28
469	128	Кредит Экспресс	3186	Ростовская обл.	2616536	2033358	583178	28.68
470	59	Йошкар-Ола	2802	Марий Эл	2604872	2565297	39575	1.54
471	50	Проинвестбанк	784	Пермская обл.	2585471	2633902	-48431	-1.84
472	12	Преодоление	2649	Москва и обл.	2584107	3290990	-706883	-21.48
473	38	Апабанк	2404	Москва и обл.	2556531	2828510	-271979	-9.62
474	131	Газнефтьбанк	3223	Саратовская обл.	2546713	1937705	609008	31.43
475	133	Канский	860	Красноярский край	2546093	1926846	619247	32.14
476	101	Вестерн Юнион ДП Восток	2726	Москва и обл.	2544514	2135613	408901	19.15
477	202	Промышленно-Финансовое Сотрудничество	2410	Москва и обл.	2540451	1274842	1265609	99.28
478	109	Владбизнесбанк	903	Владимирская обл.	2539316	2081446	457870	22
479	313	K2 Банк	2851	Карачаево-Черкесия	2526348	647252	1879096	290.32
480	-30	Еврокредит	2957	Москва и обл.	2519476	3884238	-1364762	-35.14
481	34	Унифондбанк	3416	Москва и обл.	2482124	2762509	-280385	-10.15
482	89	Национальный Корпоративный Банк	3422	Москва и обл.	2469866	2209398	260468	11.79
483	67	Столичный Кредит	2853	Москва и обл.	2450587	2401114	49473	2.06
484	150	Михайловский ПЖСБ	2961	Волгоградская обл.	2447057	1642816	804241	48.96
485	316	Внешфинбанк	3173	Краснодарский край	2445101	623294	1821807	292.29
486	53	ИРС	272	Москва и обл.	2441123	2470130	-29007	-1.17
487	170	Народный Банк	2249	Карачаево-Черкесия	2397401	1445344	952057	65.87
488	322	Соверен Банк	3206	Москва и обл.	2381762	557639	1824123	327.12
489	24	Первый Инвестиционный банк	604	Москва и обл.	2371218	2801744	-430526	-15.37
490	76	Новация	840	Адыгея	2371157	2272926	98231	4.32
491	118	БСТ-Банк	2883	Кемеровская обл.	2370338	1920856	449482	23.4
492	52	Резерв	2364	Челябинская обл.	2358966	2444150	-85184	-3.49
493	97	Татагропромбанк	728	Татарстан	2352605	2069262	283343	13.69
494	301	Тальменка-Банк	826	Алтайский край	2332670	639135	1693535	264.97
495	106	Викинг	2	Санкт-Петербург и обл.	2321699	1981837	339862	17.15
496	129	Златкомбанк	568	Москва и обл.	2265506	1716267	549239	32
497	6	Северо-Западный 1 Альянс Банк	766	Санкт-Петербург и обл.	2259821	2921629	-661808	-22.65
498	156	Международный Строительный Банк	3484	Москва и обл.	2247703	1472559	775144	52.64
499	38	Яринтербанк	2564	Ярославская обл.	2228750	2481723	-252973	-10.19
500	31	Вкабанк	1027	Астраханская обл.	2228103	2535612	-307509	-12.13
501	211	Миръ	3089	Москва и обл.	2224145	1084482	1139663	105.09
502	114	Далена	1948	Москва и обл.	2221645	1801108	420537	23.35
503	57	Новый Символ	370	Москва и обл.	2220085	2323239	-103154	-4.44
504	3	Капитал	575	Москва и обл.	2194772	2842771	-647999	-22.79
505	83	Торжокуниверсалбанк	933	Тверская обл.	2160795	2071629	89166	4.3
506	83	Екатерининский	2167	Москва и обл.	2156854	2070347	86507	4.18
507	68	Единый Строительный Банк	3506	Омская обл.	2118402	2176615	-58213	-2.67
508	76	Кредпромбанк	1165	Ярославская обл.	2095161	2083906	11255	0.54
509	67	Спиритбанк	2053	Тульская обл.	2073117	2162518	-89401	-4.13
510	57	Бум-Банк	1137	Кабардино-Балкария	2069065	2271209	-202144	-8.9
511	81	Современные Стандарты Бизнеса	3397	Москва и обл.	2042670	2062438	-19768	-0.96
512	149	Уралфинанс	1370	Свердловская обл.	2036633	1424120	612513	43.01
513	17	Индустриальный Сберегательный Банк	3175	Москва и обл.	2034682	2544999	-510317	-20.05
514	134	Алтынбанк	2070	Татарстан	2022682	1492542	530140	35.52
515	80	Московский Вексельный Банк	2697	Москва и обл.	2006188	2039557	-33369	-1.64
516	135	Мосводоканалбанк	2863	Москва и обл.	2005590	1483198	522392	35.22
517	-38	Финансовый Капитал	3288	Санкт-Петербург и обл.	2001445	3393181	-1391736	-41.02
518	45	Пермь	875	Пермская обл.	2001216	2313300	-312084	-13.49
519	235	ЮМК	3495	Краснодарский край	1947154	820864	1126290	137.21
520	97	Старооскольский Агропромбанк	1050	Белгородская обл.	1936746	1797958	138788	7.72
521	-68	Бинбанк Сургут	1701	Ханты-Мансийский АО — Югра	1933209	3803309	-1870100	-49.17
522	89	Америкэн Экспресс Банк	3460	Москва и обл.	1914641	1895918	18723	0.99
523	47	Риал-Кредит	3393	Москва и обл.	1896195	2214107	-317912	-14.36
524	108	Глобус	2438	Москва и обл.	1889400	1656588	232812	14.05
525	27	Россита-Банк	3257	Москва и обл.	1873773	2380391	-506618	-21.28
526	136	Булгар Банк	1917	Татарстан	1861691	1423723	437968	30.76
527	115	Акцент	696	Оренбургская обл.	1850214	1561513	288701	18.49
528	68	Стелла-Банк	2948	Ростовская обл.	1839473	2037262	-197789	-9.71
529	51	КОР	2148	Волгоградская обл.	1839079	2107546	-268467	-12.74
530	90	Социум-Банк	2881	Москва и обл.	1837207	1783485	53722	3.01
531	16	Мострансбанк	2258	Москва и обл.	1819213	2419586	-600373	-24.81
532	148	Вологдабанк	992	Вологодская обл.	1813058	1269814	543244	42.78
533	88	Руна-Банк	3207	Москва и обл.	1797115	1774239	22876	1.29
534	99	Кетовский Коммерческий Банк	842	Курганская обл.	1787144	1643888	143256	8.71
535	21	Крона-Банк	2499	Иркутская обл.	1769625	2354089	-584464	-24.83
536	90	Майкопбанк	1136	Адыгея	1768764	1706685	62079	3.64
537	63	Нальчик	695	Кабардино-Балкария	1768378	1982235	-213857	-10.79
538	53	Холмск	503	Сахалинская обл.	1753329	2068434	-315105	-15.23
539	47	Дом-Банк	3209	Москва и обл.	1749007	2082338	-333331	-16.01
540	101	Межрегиональный Клиринговый Банк	2543	Москва и обл.	1739928	1568392	171536	10.94
541	238	РУБанк	2813	Москва и обл.	1726380	712139	1014241	142.42
542	102	Кемсоцинбанк	96	Кемеровская обл.	1694451	1557919	136532	8.76
543		Икано Банк	3519	Центр	1687103			
544	78	Банк МБФИ	2073	Москва и обл.	1684187	1759256	-75069	-4.27
545	59	Тагилбанк	1635	Свердловская обл.	1656600	1959999	-303399	-15.48
546	72	Вэлтон Банк	1105	Белгородская обл.	1649418	1795394	-145976	-8.13
547	68	Приобье	537	Ханты-Мансийский АО — Югра	1618801	1837160	-218359	-11.89
548	176	1Банк	2896	Северная Осетия — Алания	1594867	998963	595904	59.65
549	49	Мурманский Расчетный Центр	3341	Мурманская обл.	1589139	1994981	-405842	-20.34
550	80	Примтеркомбанк	21	Приморский край	1577183	1688255	-111072	-6.58
551	117	Великие Луки Банк	598	Псковская обл.	1574847	1355954	218893	16.14
552	165	Сельмашбанк	106	Ростовская обл.	1571993	1054513	517480	49.07
553	157	Ноосфера	2650	Республика Алтай	1564310	1103917	460393	41.71
554	-53	Коммерческий Банк Развития	3364	Москва и обл.	1545235	2944572	-1399337	-47.52
555	88	Калуга	1151	Калужская обл.	1543614	1558231	-14617	-0.94
556		Оней Банк	3516	Москва и обл.	1540248			
557	81	Соколовский	2830	Москва и обл.	1539609	1628234	-88625	-5.44
558	20	ИК Банк	1732	Татарстан	1535155	2128177	-593022	-27.87
559	65	Новый Кредитный Союз	3139	Москва и обл.	1526368	1717513	-191145	-11.13
560	113	Спутник	1071	Оренбургская обл.	1509651	1304113	205538	15.76
561	213	Вятич	2796	Рязанская обл.	1500006	729753	770253	105.55
562	-54	Инкаробанк	2696	Москва и обл.	1496667	2837089	-1340422	-47.25
563	84	Гринкомбанк	1184	Иркутская обл.	1494436	1492731	1705	0.11
564	151	Евроазиатский Инвестиционный Банк	2897	Москва и обл.	1493706	1067410	426296	39.94
565	126	Первый Дортрансбанк	3271	Кировская обл.	1449380	1199364	250016	20.85
566	297	Регнум	3373	Москва и обл.	1437759	283411	1154348	407.31
567	110	Арзамас	1281	Нижегородская обл.	1433388	1286469	146919	11.42
568	71	РФИ Банк	3351	Москва и обл.	1432609	1618437	-185828	-11.48
569	-4	Кредитинвест	1197	Дагестан	1422893	2282978	-860085	-37.67
570	59	Жилкредит	1736	Москва и обл.	1417934	1688987	-271053	-16.05
571	56	Почтобанк	1788	Пермская обл.	1412392	1703322	-290930	-17.08
572	81	Саратов	330	Саратовская обл.	1395717	1478159	-82442	-5.58
573	-16	Пульс Столицы	3002	Москва и обл.	1384697	2344528	-959831	-40.94
574	148	Взаимодействие	1704	Новосибирская обл.	1382603	1018814	363789	35.71
575	117	Синергия	2884	Саратовская обл.	1371915	1195537	176378	14.75
576	-44	Банк РМП	2574	Москва и обл.	1353074	2518692	-1165618	-46.28
577	110	Саммит Банк	85	Приморский край	1345615	1247159	98456	7.89
578		ПэйПал РУ	3517	Москва и обл.	1292588			
579	14	Сталь Банк	2248	Москва и обл.	1275044	2056366	-781322	-38
580	72	Сервис-Резерв	2034	Москва и обл.	1251450	1478309	-226859	-15.35
581	148	МТИ-Банк	1052	Москва и обл.	1225159	968276	256883	26.53
582	183	Арсенал	3000	Москва и обл.	1225030	771099	453931	58.87
583	168	Динамичные Системы	3439	Москва и обл.	1219769	834370	385399	46.19
584	-5	Тендер-Банк	2252	Москва и обл.	1215979	2116686	-900707	-42.55
585	124	Химик	1114	Нижегородская обл.	1196427	1109170	87257	7.87
586	37	Санкт-Петербургский Банк Инвестиций	3468	Санкт-Петербург и обл.	1195323	1719847	-524524	-30.5
587	102	Новый Промышленный Банк	930	Москва и обл.	1189889	1216217	-26328	-2.16
588	11	Национальный Банк Взаимного Кредита	3214	Москва и обл.	1184069	1983824	-799755	-40.31
589	158	Космос	2245	Москва и обл.	1182618	856873	325745	38.02
590	41	Максима	3379	Москва и обл.	1181475	1678009	-496534	-29.59
591	125	НоваховКапиталБанк	635	Москва и обл.	1177963	1063587	114376	10.75
592	115	Финарс Банк	2938	Москва и обл.	1161064	1116561	44503	3.99
593	133	Камский Горизонт	2554	Татарстан	1149427	988891	160536	16.23
594	-51	Финтрастбанк	3104	Москва и обл.	1133371	2450165	-1316794	-53.74
595	239	Южный Региональный Банк	3015	Ростовская обл.	1118583	443582	675001	152.17
596	40	Русский Элитарный Банк	3231	Москва и обл.	1099141	1634016	-534875	-32.73
597	48	Акрополь	3027	Москва и обл.	1091477	1554137	-462660	-29.77
598	122	Тетраполис	1586	Санкт-Петербург и обл.	1087731	1024161	63570	6.21
599	135	Металлург	2877	Москва и обл.	1080206	924694	155512	16.82
600	152	Москва	1661	Москва и обл.	1063879	823681	240198	29.16
601	122	ЕАТП Банк	1765	Астраханская обл.	1062758	1013595	49163	4.85
602	91	Дон-Тексбанк	1818	Ростовская обл.	1062135	1184945	-122810	-10.36
603	105	Регионфинансбанк	3357	Москва и обл.	1059621	1111042	-51421	-4.63
604	42	Республиканский Кредитный Альянс	3017	Москва и обл.	1054509	1518453	-463944	-30.55
605	120	Мурманский Социальный Коммерческий Банк	2722	Мурманская обл.	1048048	998956	49092	4.91
606	97	Московский Клиринговый Центр	3314	Москва и обл.	1047646	1142158	-94512	-8.27
607	89	Курган	2568	Курганская обл.	1039874	1174239	-134365	-11.44
608	56	Онего	2484	Карелия	1019876	1375727	-355851	-25.87
609	153	Невастройинвест	1926	Санкт-Петербург и обл.	1011756	779408	232348	29.81
610	122	Байкалкредобанк	2990	Иркутская обл.	1007966	938463	69503	7.41
611	120	Спецстройбанк	236	Москва и обл.	997033	943098	53935	5.72
612	138	Московский Национальный Инвестиционный Банк	3181	Москва и обл.	982876	843346	139530	16.54
613	159	Первоуральскбанк	965	Свердловская обл.	981480	748618	232862	31.11
614	134	Кузбассхимбанк	2868	Кемеровская обл.	960603	855203	105400	12.32
615	80	Севзапинвестпромбанк	2152	Санкт-Петербург и обл.	954616	1178293	-223677	-18.98
616	65	Си Ди Би Банк	3339	Краснодарский край	946968	1269749	-322781	-25.42
617	151	Ресурс-Траст	3122	Москва и обл.	933987	763675	170312	22.3
618	127	Классик Эконом Банк	3298	Северная Осетия — Алания	929326	875633	53693	6.13
619	127	Акция	927	Ивановская обл.	924648	861618	63030	7.32
620	82	Объединенный Банк Республики	1016	Чувашия	924142	1146996	-222854	-19.43
621	109	Вакобанк	1291	Псковская обл.	923446	944298	-20852	-2.21
622	118	Центрально-Азиатский	3037	Хакасия	900669	904249	-3580	-0.4
623	147	Русский Финансовый Альянс	2035	Москва и обл.	900049	755964	144085	19.06
624	163	Майский	1673	Кабардино-Балкария	891186	672899	218287	32.44
625	46	Тексбанк	2756	Карачаево-Черкесия	884564	1308343	-423779	-32.39
626	92	Новый Век	3417	Москва и обл.	882328	1047522	-165194	-15.77
627	-102	Эльбин	2267	Дагестан	867839	2617728	-1749889	-66.85
628	136	Славянбанк	804	Новгородская обл.	861242	772547	88695	11.48
629	165	Народный Инвестиционный Банк	2876	Самарская обл.	819982	640318	179664	28.06
630	55	Флора-Москва	533	Москва и обл.	818891	1250876	-431985	-34.53
631	47	Вестинтербанк	3398	Москва и обл.	813385	1280936	-467551	-36.5
632	127	Прохладный	874	Кабардино-Балкария	806395	807230	-835	-0.1
633	185	Межрегиональный Банк Реконструкции	2620	Москва и обл.	806272	527832	278440	52.75
634	94	Жилстройбанк	2769	Москва и обл.	803677	971625	-167948	-17.29
635	168	Народный Земельно-Промышленный Банк	2873	Алтайский край	793186	601426	191760	31.88
636	146	РусьРегионБанк	685	Москва и обл.	763781	688420	75361	10.95
637	162	Стандарт-Кредит	841	Адыгея	761762	625959	135803	21.7
638	2	Уралприватбанк	153	Свердловская обл.	759717	1614055	-854338	-52.93
639	118	Анелик РУ	3443	Москва и обл.	751714	808612	-56898	-7.04
640	120	Русский Банк Сбережений	779	Ставропольский край	749660	805483	-55823	-6.93
641	49	Расчетный Дом	3350	Москва и обл.	720587	1204742	-484155	-40.19
642	138	Геобанк	2027	Москва и обл.	704121	695939	8182	1.18
643	90	Турбобанк	3203	Санкт-Петербург и обл.	688170	925611	-237441	-25.65
644	131	Балаково-Банк	444	Саратовская обл.	679778	729436	-49658	-6.81
645	203	РИТЦ Банк	2677	Москва и обл.	666891	396766	270125	68.08
646	171	АлтайБизнес-Банк	2388	Алтайский край	656709	530608	126101	23.77
647	138	Банк РСИ	3415	Москва и обл.	655093	682535	-27442	-4.02
648	152	Гефест	1046	Тверская обл.	650068	624182	25886	4.15
649	122	Прокоммерцбанк	2996	Москва и обл.	616816	754408	-137592	-18.24
650	207	Терра	3476	Москва и обл.	610465	310988	299477	96.3
651	145	Холдинвестбанк	2837	Москва и обл.	604011	639046	-35035	-5.48
652	155	Новокиб	1747	Кемеровская обл.	603630	565807	37823	6.68
653	167	ВРБ Москва	3499	Москва и обл.	600586	515815	84771	16.43
654	73	Азия Банк	3183	Москва и обл.	596088	976187	-380099	-38.94
655	151	АвтоКредитБанк	1973	Татарстан	595849	574832	21017	3.66
656	97	Лидер	3304	Москва и обл.	582735	821424	-238689	-29.06
657	101	СМБ-Банк	3504	Санкт-Петербург и обл.	582081	807432	-225351	-27.91
658	156	Энтузиастбанк	3048	Москва и обл.	561023	543661	17362	3.19
659	129	Башпромбанк	1006	Башкортостан	525778	657014	-131236	-19.97
660	165	Иронбанк	1724	Москва и обл.	520368	505545	14823	2.93
661	171	Народный Банк Республики Тыва	1309	Тыва	516824	475607	41217	8.67
662	76	Международный Расчетный Банк	3028	Москва и обл.	513357	906209	-392852	-43.35
663	168	Дружба	990	Тюменская обл.	503779	478847	24932	5.21
664	33	Интеркоопбанк	2803	Москва и обл.	502972	1171556	-668584	-57.07
665	163	Логос	3233	Москва и обл.	497238	484778	12460	2.57
666	153	МВС Банк	2407	Дагестан	488250	517206	-28956	-5.6
667	159	Кредо Финанс	793	Дагестан	488238	493769	-5531	-1.12
668	161	АББ	2937	Москва и обл.	486412	482834	3578	0.74
669	153	Европейский Стандарт	3200	Кабардино-Балкария	486282	513259	-26977	-5.26
670	143	Стар Альянс	3433	Москва и обл.	473331	549557	-76226	-13.87
671	131	Эко-Инвест	3116	Москва и обл.	464682	615033	-150351	-24.45
672	133	Берейт	3505	Санкт-Петербург и обл.	453604	579596	-125992	-21.74
673	170	Таганрогбанк	3136	Ростовская обл.	438504	409092	29412	7.19
674	167	Алжан	2491	Дагестан	436091	422140	13951	3.3
675	164	ГРиС-Банк	1928	Ставропольский край	434826	423731	11095	2.62
676	176	Альтернатива	3452	Москва и обл.	426554	345903	80651	23.32
677	104	Промсвязьинвест	2761	Дагестан	416824	693948	-277124	-39.93
678	146	Информпрогресс	2166	Москва и обл.	415298	509231	-93933	-18.45
679	110	Тульский Расчетный Центр	3380	Тульская обл.	405742	656298	-250556	-38.18
680	141	Рента-Банк	3095	Москва и обл.	402806	515479	-112673	-21.86
681	105	Континенталь	3184	Ставропольский край	396869	675601	-278732	-41.26
682	200	РИБ	2749	Москва и обл.	388737	130231	258506	198.5
683	-119	Банк Сберегательно-кредитного сервиса	3224	Москва и обл.	385835	2293851	-1908016	-83.18
684	172	Лэнд-Банк	1478	Москва и обл.	378316	316690	61626	19.46
685	193	Монета.ру	3508	Марий Эл	365359	145948	219411	150.34
686	104	ОЛМА-Банк	3250	Москва и обл.	364502	653537	-289035	-44.23
687	181	Рунэтбанк	2829	Москва и обл.	358944	227806	131138	57.57
688	179	Тайдон	2085	Кемеровская обл.	356943	238413	118530	49.72
689	-148	Национальный Банк Сбережений	1949	Ивановская обл.	354638	2459166	-2104528	-85.58
690	140	НКБ	2942	Москва и обл.	348164	481064	-132900	-27.63
691	170	ФФИН Банк (бывш. Охабанк)	1143	Сахалинская обл.	341722	288244	53478	18.55
692	167	Бринкс	3486	Москва и обл.	336866	292824	44042	15.04
693	179	Северстройбанк	3507	Вологодская обл.	323114	201064	122050	60.7
694	-91	Нарат	1902	Саратовская обл.	307405	1960806	-1653401	-84.32
695	11	Приполярком	507	Тюменская обл.	271335	1125621	-854286	-75.89
696		Универсальная электронная карта	3524	Москва и обл.	265405			
697	178	Русское Финансовое Общество	3427	Москва и обл.	237600	168366	69234	41.12
698	172	Майма	1037	Москва и обл.	226153	207678	18475	8.9
699	151	Расчетная Палата СВМБ	3324	Самарская обл.	225891	372507	-146616	-39.36
700	160	Континент Финанс	149	Москва и обл.	222793	290119	-67326	-23.21
701	153	Сетевая Расчетная Палата	3332	Татарстан	217565	329964	-112399	-34.06
702	167	Красноярский Краевой Расчетный Центр	3483	Красноярский край	215896	226986	-11090	-4.89
703	189	Инновационный Расчетный Центр	3447	Москва и обл.	193905	56227	137678	244.86
704	183	Интеррасчет	1618	Москва и обл.	187041	76687	110354	143.9
705		Электронный платежный сервис	3509	Москва и обл.	186653			
706	165	Деньги.Мэйл.Ру	3511	Москва и обл.	180888	203787	-22899	-11.24
707	130	Петербургский Расчетный Центр	3306	Санкт-Петербург и обл.	161218	429987	-268769	-62.51
708		Единая касса	3512	Москва и обл.	143407			
709	175	Фидбэк	3502	Москва и обл.	129947	117824	12123	10.29
710		НКО «МОБИ.Деньги»	3523	Москва и обл.	101768			
711	175	Вест	2605	Москва и обл.	100796	77281	23515	30.43
712	171	КредитАльянс	3472	Вологодская обл.	94979	126588	-31609	-24.97
713	168	Банковские Информационные Технологии	3318	Тульская обл.	78262	130988	-52726	-40.25
714	163	Умут	2435	Дагестан	75326	152493	-77167	-50.6
715	164	Платежный Клиринговый Дом	3343	Москва и обл.	65132	145344	-80212	-55.19
716	174	Сергиево-Посадская Расчетная Палата	384	Москва и обл.	55882	58090	-2208	-3.8
717		Премиум	3514	Москва и обл.	51335			
718	176	Транзит	2688	Дагестан	41519	36160	5359	14.82
719		21 Век	3309	Санкт-Петербург и обл.	27256			
720	182	АРБ-Инкасс	3353	Москва и обл.	17856	2767	15089	545.32
721	177	Частный Расчетно-Кассовый Центр	3420	Москва и обл.	13992	24381	-10389	-42.61
722	179	Клиринговый Дом	3430	Санкт-Петербург и обл.	4318	4251	67	1.58
