Позиция в рейтинге	Изменение позиции в рейтинге	Название банка	Номер лицензии	Регион регистрации	Декабрь, 2011, тыс. рублей	Январь, 2011, тыс. рублей	Изменение, тыс. рублей	Изменение, %
1	0	Сбербанк России	1481	Москва и обл.	10414994686	9145192910	1269801776	13.88
2	0	ВТБ	1000	Санкт-Петербург и обл.	3980335738	2822169844	1158165894	41.04
3	0	Газпромбанк	354	Москва и обл.	2359784575	1874115343	485669232	25.91
4	0	Россельхозбанк	3349	Москва и обл.	1385434005	1080160552	305273453	28.26
5	1	ВТБ 24	1623	Москва и обл.	1249690887	937768778	311922109	33.26
6	-1	Банк Москвы	2748	Москва и обл.	1222865312	954232472	268632840	28.15
7	0	Альфа-Банк	1326	Москва и обл.	964457258	880202924	84254334	9.57
8	0	ЮниКредит Банк	1	Москва и обл.	844319437	684030299	160289138	23.43
9	2	Росбанк	2272	Москва и обл.	648554614	472042022	176512592	37.39
10	-1	Райффайзенбанк	3292	Москва и обл.	611390089	509652091	101737998	19.96
11	-1	Промсвязьбанк	3251	Москва и обл.	555508092	504501914	51006178	10.11
12	3	ФК Открытие	2209	Москва и обл.	482388866	382433139	99955727	26.14
13	1	Транскредитбанк	2142	Москва и обл.	477166819	389314178	87852641	22.57
14	-2	Банк Уралсиб	2275	Москва и обл.	450314106	434868594	15445512	3.55
15	-2	МДМ Банк	323	Новосибирская обл.	380696204	413077739	-32381535	-7.84
16	0	Банк «Санкт-Петербург»	436	Санкт-Петербург и обл.	330922241	284066227	46856014	16.49
17	3	Ак Барс	2590	Татарстан	297806733	247173561	50633172	20.48
18	0	Россия	328	Санкт-Петербург и обл.	292750873	261075088	31675785	12.13
19	0	Ситибанк	2557	Москва и обл.	284517825	253826123	30691702	12.09
20	1	Нордеа Банк	3016	Москва и обл.	253436909	193454562	59982347	31.01
21	13	ИНГ Банк	2495	Москва и обл.	230226362	122812094	107414268	87.46
22	4	Московский Кредитный Банк	1978	Москва и обл.	228051882	168402759	59649123	35.42
23	4	Зенит	3255	Москва и обл.	219457967	165994490	53463477	32.21
24	1	Ханты-Мансийский банк Открытие	1971	Тюменская обл.	217083159	170270566	46812593	27.49
25	-2	Петрокоммерц	1776	Москва и обл.	214253293	183950520	30302773	16.47
26	-4	Связь-Банк	1470	Москва и обл.	210291267	184396769	25894498	14.04
27	-3	Возрождение	1439	Москва и обл.	187772455	175459419	12313036	7.02
28	2	Русский Стандарт	2289	Москва и обл.	178085397	146956376	31129021	21.18
29	3	Банк «Открытие»	2179	Москва и обл.	173553413	137479910	36073503	26.24
30	-2	Национальный Банк «Траст»	3279	Москва и обл.	166718413	163242584	3475829	2.13
31	7	Глобэкс	1942	Москва и обл.	163423372	112012705	51410667	45.9
32	5	Хоум Кредит Банк	316	Москва и обл.	153330348	119704304	33626044	28.09
33	-4	МТС Банк	2268	Москва и обл.	142744674	162350505	-19605831	-12.08
34	21	Национальный Расчетный Депозитарий	3294	Москва и обл.	141205447	75494059	65711388	87.04
35	6	Восточный Экспресс Банк	1460	Амурская обл.	130306102	99900786	30405316	30.44
36	25	Дойче Банк	3328	Москва и обл.	129964744	69629157	60335587	86.65
37	2	Московский Индустриальный Банк	912	Москва и обл.	128639609	108812344	19827265	18.22
38	2	ОТП Банк	2766	Москва и обл.	122014462	106094519	15919943	15.01
39	-4	Абсолют Банк	2306	Москва и обл.	118468517	120917242	-2448725	-2.03
40	3	Бинбанк	2562	Москва и обл.	116042846	98185640	17857206	18.19
41	-8	Национальный Клиринговый Центр	3466	Москва и обл.	114248177	124948174	-10699997	-8.56
42	10	Транскапиталбанк (ТКБ)	2210	Москва и обл.	108439036	78928045	29510991	37.39
43	1	Русфинанс Банк	1792	Самарская обл.	104632492	93919356	10713136	11.41
44	1	МСП Банк	3340	Москва и обл.	100604834	90501334	10103500	11.16
45	12	Уральский Банк Реконструкции и Развития	429	Свердловская обл.	99314774	72963477	26351297	36.12
46	1	СКБ-Банк	705	Свердловская обл.	98842450	87676982	11165468	12.73
47	16	Инвестторгбанк	2763	Москва и обл.	98373759	65734309	32639450	49.65
48	19	БНП Париба Банк	3407	Москва и обл.	98117101	62008853	36108248	58.23
49	-7	Росгосстрах Банк	3073	Москва и обл.	97473527	98649321	-1175794	-1.19
50	-4	Кредит Европа Банк	3311	Москва и обл.	95802569	89337320	6465249	7.24
51	8	СМП Банк	3368	Москва и обл.	93085267	71555041	21530226	30.09
52	-3	Юниаструм Банк	2771	Москва и обл.	91849176	84919775	6929401	8.16
53	-2	Пробизнесбанк	2412	Москва и обл.	91358150	81735214	9622936	11.77
54	-6	Банк Интеза	2216	Москва и обл.	88826623	86681068	2145555	2.48
55	7	Внешпромбанк	3261	Москва и обл.	84240694	69080449	15160245	21.95
56	9	Новикомбанк	2546	Москва и обл.	83173896	65275597	17898299	27.42
57	-3	РосЕвроБанк	3137	Москва и обл.	82931660	75522018	7409642	9.81
58	-5	Союз	2307	Москва и обл.	82715580	75981011	6734569	8.86
59	-23	КИТ Финанс Инвестиционный Банк	1911	Санкт-Петербург и обл.	82406665	120190459	-37783794	-31.44
60	10	Авангард	2879	Москва и обл.	75968475	60283261	15685214	26.02
61	-5	Балтийский Банк	128	Москва и обл.	75737324	74223760	1513564	2.04
62	4	Татфондбанк	3058	Татарстан	74521249	64280168	10241081	15.93
63	-13	ЦентроКредит	121	Москва и обл.	74425905	82662448	-8236543	-9.96
64	-6	Мастер-Банк	2176	Москва и обл.	74354047	72291248	2062799	2.85
65	4	Всероссийский Банк Развития Регионов	3287	Москва и обл.	73782496	60928895	12853601	21.1
66	27	Еврофинанс Моснарбанк	2402	Москва и обл.	73001932	36560721	36441211	99.67
67	-3	Запсибкомбанк	918	Тюменская обл.	72861738	65347358	7514380	11.5
68	-8	Собинбанк	1317	Москва и обл.	71625935	69721374	1904561	2.73
69		ДельтаКредит	3338	Москва и обл.	64598532			
70	11	Пересвет	2110	Москва и обл.	63964329	46845437	17118892	36.54
71	20	Эйч-Эс-Би-Си Банк (HSBC)	3290	Москва и обл.	63554143	37023451	26530692	71.66
72	18	Российский Капитал	2312	Москва и обл.	61575424	37877083	23698341	62.57
73	6	Ренессанс Кредит	3354	Москва и обл.	60923438	47814743	13108695	27.42
74	6	Совкомбанк	963	Костромская обл.	59223732	47286358	11937374	25.24
75	0	Локо-Банк	2707	Москва и обл.	58969279	51306437	7662842	14.94
76	2	Балтинвестбанк	3176	Санкт-Петербург и обл.	58574525	50442205	8132320	16.12
77	6	Азиатско-Тихоокеанский Банк	1810	Амурская обл.	56262332	43856432	12405900	28.29
78	-1	Центр-инвест	2225	Ростовская обл.	56127713	50680942	5446771	10.75
79	-3	Фондсервисбанк	2989	Москва и обл.	55195195	50694888	4500307	8.88
80	-8	Международный Банк Санкт-Петербурга (МБСП)	197	Санкт-Петербург и обл.	54678761	52805630	1873131	3.55
81	-8	Металлинвестбанк	2440	Москва и обл.	52771540	52570785	200755	0.38
82	53	Саровбизнесбанк	2048	Нижегородская обл.	52664086	19306420	33357666	172.78
83	-9	Меткомбанк (Каменск-Уральский)	2443	Свердловская обл.	48693048	51367609	-2674561	-5.21
84	-13	Королевский Банк Шотландии	2594	Москва и обл.	47298059	53399149	-6101090	-11.43
85	2	Банк Сберегательно-кредитного сервиса	3224	Москва и обл.	47215838	40415249	6800589	16.83
86	10	Креди Агриколь КИБ	1680	Санкт-Петербург и обл.	46583782	32778474	13805308	42.12
87	-19	Национальный Резервный Банк	2170	Москва и обл.	46267241	61987684	-15720443	-25.36
88	-4	Сургутнефтегазбанк	588	Тюменская обл.	44386621	42727933	1658688	3.88
89	-4	СБ Банк (Судостроительный банк)	2999	Москва и обл.	41292579	41028660	263919	0.64
90	-2	Инвестбанк	107	Москва и обл.	40987354	40095628	891726	2.22
91	1	Национальный Стандарт	3421	Москва и обл.	40768639	36860804	3907835	10.6
92	3	Национальный Торговый Банк	3087	Самарская обл.	37888646	32810446	5078200	15.48
93	5	Бинбанк кредитные карты	2827	Москва и обл.	37544041	31954003	5590038	17.49
94	0	Первобанк	3461	Самарская обл.	37078469	34178629	2899840	8.48
95	2	Международный Финансовый Клуб	2618	Москва и обл.	37025383	32349045	4676338	14.46
96	3	Нота-Банк	2913	Москва и обл.	36408560	31866656	4541904	14.25
97	37	Стройкредит	18	Москва и обл.	33745345	19331673	14413672	74.56
98	5	Дальневосточный Банк	843	Приморский край	33062344	28421150	4641194	16.33
99	1	Таврический	2304	Санкт-Петербург и обл.	32802299	30434874	2367425	7.78
100	75	Связной Банк	1961	Москва и обл.	32147117	13219557	18927560	143.18
101	-15	Коммерцбанк (Евразия)	3333	Москва и обл.	32126887	40706309	-8579422	-21.08
102	16	Экспресс-Волга	3085	Саратовская обл.	30685914	23627043	7058871	29.88
103	6	Челябинвестбанк	493	Челябинская обл.	30610026	27407673	3202353	11.68
104	-3	Челиндбанк	485	Челябинская обл.	30222954	29712566	510388	1.72
105	3	Современный Коммерческий Банк (бывш. ДжиИ Мани Банк)	3316	Москва и обл.	30049814	27672430	2377384	8.59
106	1	НС Банк	3124	Москва и обл.	29539298	27724156	1815142	6.55
107	-2	Кубань Кредит	2518	Краснодарский край	29428451	28252870	1175581	4.16
108	-6	Расчетная Палата РТС	3335	Москва и обл.	29322294	29067133	255161	0.88
109	1	Кедр	1574	Москва и обл.	28486000	26134110	2351890	9
110	15	Межтопэнергобанк	2956	Москва и обл.	27854662	21187801	6666861	31.47
111	8	Газбанк	2316	Самарская обл.	27714485	23296848	4417637	18.96
112	15	Банк Кредит Свисс	2494	Москва и обл.	27679743	21065035	6614708	31.4
113	19	Интеркоммерц Банк	1657	Москва и обл.	27577895	20339284	7238611	35.59
114	56	Тинькофф Банк	2673	Москва и обл.	27560985	14036326	13524659	96.35
115	-4	СДМ-Банк	1637	Москва и обл.	27227072	25726845	1500227	5.83
116	10	Кредит Урал Банк	2584	Челябинская обл.	26956129	21133137	5822992	27.55
117	25	Московский Областной Банк	1751	Москва и обл.	26736661	18301494	8435167	46.09
118	4	Приморье	3001	Приморский край	26292987	22176932	4116055	18.56
119	-2	Первый Республиканский Банк	1730	Москва и обл.	26271048	23774734	2496314	10.5
120	-8	Далькомбанк	84	Хабаровский край	26221511	25508982	712529	2.79
121	-32	Сведбанк	3064	Москва и обл.	26090436	39397158	-13306722	-33.78
122	11	Меткомбанк (Череповец)	901	Вологодская обл.	26079124	20048608	6030516	30.08
123	-9	Банк СГБ	2816	Вологодская обл.	25436627	25045288	391339	1.56
124	12	Фора-Банк	1885	Москва и обл.	25385554	19103638	6281916	32.88
125	-9	Крайинвестбанк	3360	Краснодарский край	25278550	24335850	942700	3.87
126	29	Банк БФА	3038	Санкт-Петербург и обл.	25170385	16053157	9117228	56.79
127	-21	Москоммерцбанк	3365	Москва и обл.	24685052	27754341	-3069289	-11.06
128	46	Тойота Банк	3470	Москва и обл.	24570667	13323793	11246874	84.41
129	9	Примсоцбанк	2733	Приморский край	24417070	18685932	5731138	30.67
130	0	Банк АВБ	23	Самарская обл.	24256062	20769200	3486862	16.79
131	-7	Липецккомбанк	1242	Липецкая обл.	24202685	21354128	2848557	13.34
132	-19	Интерпромбанк	3266	Москва и обл.	23788771	25453872	-1665101	-6.54
133	-13	Русский Международный Банк	3123	Москва и обл.	23730566	23011805	718761	3.12
134	-6	М2М Прайвет Банк	1414	Москва и обл.	23160286	21050425	2109861	10.02
135	-20	Акибанк	2587	Татарстан	22697128	24397845	-1700717	-6.97
136	4	БФГ-Кредит	3068	Москва и обл.	22695714	18481522	4214192	22.8
137	27	Смоленский Банк	2029	Смоленская обл.	22052570	14476483	7576087	52.33
138	14	Натиксис Банк	3390	Москва и обл.	21999724	16486584	5513140	33.44
139	-16	АМБ Банк	3036	Москва и обл.	21883569	21906686	-23117	-0.11
140	9	Народный Кредит	2401	Москва и обл.	21618901	17349229	4269672	24.61
141	-12	Девон-Кредит	1972	Татарстан	21123312	20787871	335441	1.61
142	2	Кольцо Урала	65	Свердловская обл.	20674098	18220804	2453294	13.46
143	-12	Агропромкредит	2880	Москва и обл.	20493222	20555662	-62440	-0.3
144	-3	Альта-Банк	2269	Москва и обл.	20469063	18395987	2073076	11.27
145	-6	Мой Банк	2939	Москва и обл.	20328428	18560710	1767718	9.52
146	-1	Росэнергобанк	2211	Москва и обл.	19956630	18141779	1814851	10
147	3	ФИА-Банк	2542	Самарская обл.	19938246	17004436	2933810	17.25
148	11	Региональный Кредит	1927	Костромская обл.	19356494	15691016	3665478	23.36
149	-1	Уральский Финансовый Дом	249	Пермская обл.	18819496	17790223	1029273	5.79
150	-7	Банк «МБА-Москва»	3395	Москва и обл.	18731817	18242020	489797	2.68
151	2	Банк Проектного Финансирования	1677	Москва и обл.	18679484	16421164	2258320	13.75
152	-6	Уралтрансбанк	812	Свердловская обл.	18208836	18123553	85283	0.47
153	12	Левобережный	1343	Новосибирская обл.	18197654	14452373	3745281	25.91
154	467	С банк	2581	Москва и обл.	17888880	1417066	16471814	1162.39
155	11	Спурт Банк	2207	Татарстан	17600123	14383829	3216294	22.36
156	43	БМВ Банк	3482	Москва и обл.	17433119	10777167	6655952	61.76
157	-10	Солидарность (Самара)	554	Самарская обл.	17342777	18089516	-746739	-4.13
158	-21	ГПБ-Ипотека	2403	Москва и обл.	17270689	18876251	-1605562	-8.51
159	9	Тимер Банк	1581	Татарстан	17216740	14204207	3012533	21.21
160	37	Европейский Трастовый Банк	2968	Москва и обл.	16568821	11038598	5530223	50.1
161	-57	Экспобанк	2998	Москва и обл.	16541228	28362230	-11821002	-41.68
162	-11	Первый Чешско-Российский Банк	3291	Москва и обл.	16540824	16786514	-245690	-1.46
163	-9	НОМОС-Региобанк	539	Хабаровский край	16523079	16290711	232368	1.43
164	-8	Морской Банк	77	Москва и обл.	16209264	15945223	264041	1.66
165	2	Энергобанк	67	Татарстан	16173383	14320136	1853247	12.94
166	16	Образование	1521	Москва и обл.	16083380	12380872	3702508	29.91
167	9	Ланта-Банк	1920	Москва и обл.	15804821	13188388	2616433	19.84
168	-8	Интерпрогрессбанк	600	Москва и обл.	15747522	15362459	385063	2.51
169	44	Гута-Банк	256	Москва и обл.	15368989	9837645	5531344	56.23
170	13	Русстройбанк	3205	Москва и обл.	15049924	12372980	2676944	21.64
171	2	Инвесткапиталбанк	2377	Башкортостан	14773894	13488192	1285702	9.53
172	-14	Банк РСБ 24 (Русславбанк)	1073	Москва и обл.	14756305	15800716	-1044411	-6.61
173	-2	НБД-Банк	1966	Нижегородская обл.	14676936	13790564	886372	6.43
174	164	Сумитомо Мицуи	3494	Москва и обл.	14550645	4476186	10074459	225.07
175	6	БыстроБанк	1745	Удмуртия	14484195	12436282	2047913	16.47
176	9	Норвик Банк	902	Кировская обл.	14414751	12140232	2274519	18.74
177	38	Легион	3117	Москва и обл.	14038545	9682238	4356307	44.99
178	15	Интехбанк	2705	Татарстан	13836123	11294788	2541335	22.5
179	-1	Курскпромбанк	735	Курская обл.	13773453	12611861	1161592	9.21
180	182	Мир Бизнес Банк	3396	Москва и обл.	13639921	4103664	9536257	232.38
181	14	Алмазэргиэнбанк	2602	Саха (Якутия)	13434271	11231834	2202437	19.61
182	-10	Центркомбанк	2983	Москва и обл.	13428979	13624793	-195814	-1.44
183	31	Тольяттихимбанк	2507	Самарская обл.	13367620	9684657	3682963	38.03
184	146	Западный	2598	Москва и обл.	13343406	4811559	8531847	177.32
185	-8	Новокузнецкий Муниципальный Банк	2865	Кемеровская обл.	13273557	12961393	312164	2.41
186	6	Эллипс Банк	1950	Нижегородская обл.	13253233	11318501	1934732	17.09
187	-7	Рост Банк	2888	Татарстан	13078896	12504972	573924	4.59
188	-25	Мосстройэкономбанк (М Банк)	948	Москва и обл.	13075685	14687680	-1611995	-10.98
189	1	Развитие-Столица	3013	Москва и обл.	12734460	11506330	1228130	10.67
190	-21	Российский Кредит	324	Москва и обл.	12672236	14118701	-1446465	-10.25
191	-12	Держава	2738	Москва и обл.	12637350	12577394	59956	0.48
192	136	Аверс	415	Татарстан	12486997	4842635	7644362	157.86
193	-7	Петербургский Социальный Коммерческий Банк	2551	Санкт-Петербург и обл.	12314117	12031081	283036	2.35
194	32	ВУЗ-Банк	1557	Свердловская обл.	12283608	9050646	3232962	35.72
195	34	ББР Банк	2929	Москва и обл.	12084293	8723874	3360419	38.52
196	10	Фининвест	671	Москва и обл.	12029675	10224667	1805008	17.65
197	27	Советский	558	Санкт-Петербург и обл.	12024837	9090463	2934374	32.28
198	14	Первомайский	518	Краснодарский край	12010548	9951364	2059184	20.69
199	-38	Сетелем Банк	2168	Москва и обл.	11960706	14770811	-2810105	-19.02
200	36	Мерседес-Бенц Банк Рус	3473	Москва и обл.	11880436	8230807	3649629	44.34
201	51	БКС — Инвестиционный Банк	101	Новосибирская обл.	11878879	7506782	4372097	58.24
202	6	Гаранти Банк — Москва	3275	Москва и обл.	11789642	10148711	1640931	16.17
203	13	АйМаниБанк	1975	Республика Алтай	11770426	9458995	2311431	24.44
204	87	Банк ПСА Финанс Рус	3481	Москва и обл.	11729810	6153671	5576139	90.61
205	-1	Нацинвестпромбанк	3077	Москва и обл.	11710854	10251978	1458876	14.23
206	161	Рост	2589	Москва и обл.	11701737	3972024	7729713	194.6
207	-16	Росдорбанк	1573	Москва и обл.	11686658	11372850	313808	2.76
208	3	Солидарность (Москва)	1555	Москва и обл.	11675809	10005741	1670068	16.69
209	33	Национальная Факторинговая Компания	3437	Москва и обл.	11670104	8007687	3662417	45.74
210	-8	Александровский	53	Санкт-Петербург и обл.	11656578	10578832	1077746	10.19
211	55	СтарБанк	548	Москва и обл.	11566231	6961542	4604689	66.14
212	60	МАСТ-Банк	3267	Москва и обл.	11393757	6794395	4599362	67.69
213	54	Огни Москвы	2328	Москва и обл.	11385996	6912950	4473046	64.71
214	26	Энергомашбанк	52	Санкт-Петербург и обл.	11283851	8043405	3240446	40.29
215	20	Газэнергобанк	3252	Калужская обл.	11201701	8259139	2942562	35.63
216	79	Пушкино	391	Москва и обл.	11162922	5897148	5265774	89.29
217	-7	Энерготрансбанк	1307	Калининградская обл.	11137256	10016833	1120423	11.19
218	-20	Форштадт	2208	Оренбургская обл.	11081994	10903662	178332	1.64
219	-35	Углеметбанк	2997	Челябинская обл.	11020876	12359055	-1338179	-10.83
220	1	Гранд Инвест Банк	3053	Москва и обл.	10998027	9325565	1672462	17.93
221	-12	Экопромбанк	2011	Пермская обл.	10935152	10027743	907409	9.05
222	19	Алеф-Банк	2119	Москва и обл.	10674491	8012010	2662481	33.23
223	-27	Московское Ипотечное Агентство	3344	Москва и обл.	10629433	11149730	-520297	-4.67
224	-19	ТЭМБР-Банк	2764	Москва и обл.	10560648	10234314	326334	3.19
225	20	Расчетно-Кредитный Банк	103	Москва и обл.	10556561	7841349	2715212	34.63
226	305	Пойдем!	2534	Москва и обл.	10468674	1933830	8534844	441.34
227	53	Финпромбанк (ФПБ Банк)	2157	Москва и обл.	10451277	6467934	3983343	61.59
228	-25	Хлынов	254	Кировская обл.	10374812	10433537	-58725	-0.56
229	22	Социнвестбанк	1132	Башкортостан	10313454	7561032	2752422	36.4
230	-41	Аресбанк	2914	Москва и обл.	10268617	11677985	-1409368	-12.07
231	0	Интрастбанк	3144	Москва и обл.	10184740	8687811	1496929	17.23
232	-9	НК Банк	2755	Москва и обл.	9838581	9151422	687159	7.51
233	305	Балтика	967	Санкт-Петербург и обл.	9760452	1908031	7852421	411.55
234	-27	Роспромбанк	3204	Москва и обл.	9708175	10199570	-491395	-4.82
235	11	Европейский	1616	Калининградская обл.	9640124	7812558	1827566	23.39
236	-9	Оренбург	3269	Оренбургская обл.	9563682	8878421	685261	7.72
237	1	Росэксимбанк	2790	Москва и обл.	9558282	8148750	1409532	17.3
238	-117	Тройка-Д Банк	3431	Москва и обл.	9524742	22695149	-13170407	-58.03
239	-14	Прио-Внешторгбанк	212	Рязанская обл.	9500881	9064268	436613	4.82
240	16	Плюс Банк	1189	Омская обл.	9500448	7386816	2113632	28.61
241	-53	АБ Финанс	514	Москва и обл.	9431757	11700728	-2268971	-19.39
242	-12	Банк Жилищного Финансирования	3138	Москва и обл.	9376056	8690855	685201	7.88
243	-23	Банк24.ру	2227	Свердловская обл.	9328830	9366791	-37961	-0.41
244	20	Денизбанк Москва	3330	Москва и обл.	9310741	7059528	2251213	31.89
245	-51	Современный Коммерческий Ипотечный Банк	3329	Калужская обл.	9281325	11256714	-1975389	-17.55
246	32	АктивКапитал Банк	3006	Самарская обл.	9241788	6491864	2749924	42.36
247	28	Рублев	3098	Москва и обл.	9199998	6719819	2480179	36.91
248	42	СЭБ Банк	3235	Санкт-Петербург и обл.	9184888	6194386	2990502	48.28
249	9	Национальный Банк Развития Бизнеса	2795	Москва и обл.	9151972	7310350	1841622	25.19
250	-49	ЯР-Банк	3185	Москва и обл.	9147155	10666536	-1519381	-14.24
251	-2	Новосибирский Муниципальный Банк	2786	Новосибирская обл.	9111887	7720438	1391449	18.02
252	88	Холдинг-Кредит	3030	Москва и обл.	9091395	4443166	4648229	104.62
253	-5	Гарант-Инвест	2576	Москва и обл.	9075632	7779485	1296147	16.66
254	-37	Руснарбанк	3403	Москва и обл.	9037667	9423138	-385471	-4.09
255	47	СИАБ	3245	Санкт-Петербург и обл.	8961156	5752261	3208895	55.78
256	-24	Экономбанк	1319	Саратовская обл.	8933833	8505434	428399	5.04
257	43	Данске Банк	3307	Санкт-Петербург и обл.	8845823	5776147	3069676	53.14
258	-11	Замоскворецкий	1640	Москва и обл.	8815870	7802838	1013032	12.98
259	78	Ури Банк	3479	Москва и обл.	8621352	4528114	4093238	90.4
260	-21	Международный Акционерный Банк	1987	Москва и обл.	8545178	8053988	491190	6.1
261	20	БайкалБанк	2632	Бурятия	8539562	6446922	2092640	32.46
262	22	Евромет	2902	Москва и обл.	8348555	6349808	1998747	31.48
263	13	МАК-Банк	1088	Москва и обл.	8283571	6604522	1679049	25.42
264	49	РусЮгбанк	2093	Волгоградская обл.	8270388	5447005	2823383	51.83
265	131	Международный Банк Развития	2704	Москва и обл.	8254931	3561564	4693367	131.78
266	-33	Промсбербанк	1043	Москва и обл.	8238169	8449557	-211388	-2.5
267	-14	Нефтяной Альянс	2859	Москва и обл.	8180906	7504232	676674	9.02
268	5	Адмиралтейский	3054	Москва и обл.	8111779	6784601	1327178	19.56
269	-9	Русьуниверсалбанк	3293	Москва и обл.	8026546	7230574	795972	11.01
270	35	Новый Московский Банк	2932	Москва и обл.	8018102	5655639	2362463	41.77
271	-3	Башкомснаббанк	1398	Башкортостан	7920943	6842452	1078491	15.76
272	15	Кузнецкбизнесбанк	1158	Кемеровская обл.	7893497	6237547	1655950	26.55
273	-2	Акцепт	567	Новосибирская обл.	7876264	6820925	1055339	15.47
274	-40	Екатеринбург	3161	Свердловская обл.	7826680	8274710	-448030	-5.41
275	145	АйСиБиСи Банк	3475	Москва и обл.	7767937	3245253	4522684	139.36
276	-17	НОМОС-Банк-Сибирь	410	Новосибирская обл.	7623271	7237868	385403	5.32
277	-59	Снежинский	1376	Челябинская обл.	7595488	9410704	-1815216	-19.29
278	-59	Северо-Восточный Альянс	2768	Москва и обл.	7520768	9401758	-1880990	-20.01
279	27	Метробанк	2548	Москва и обл.	7512687	5654762	1857925	32.86
280	-18	Бэнк оф Чайна	2309	Москва и обл.	7434618	7161046	273572	3.82
281	67	Кузнецкий Мост	2254	Москва и обл.	7426523	4347784	3078739	70.81
282	-13	Волго-Камский Банк	282	Самарская обл.	7368110	6823159	544951	7.99
283	154	Крокус-Банк	2682	Москва и обл.	7365523	3018893	4346630	143.98
284	12	Унифин	2654	Москва и обл.	7263155	5864363	1398792	23.85
285	1	Кредит-Москва	5	Москва и обл.	7241245	6284404	956841	15.23
286	22	Экспресс	3084	Дагестан	7238080	5627478	1610602	28.62
287	-5	АФ Банк	991	Башкортостан	7221349	6412813	808536	12.61
288	19	Белгородсоцбанк	760	Белгородская обл.	7211163	5640907	1570256	27.84
289	30	Первый Экспресс	3237	Тульская обл.	7125456	5299220	1826236	34.46
290	8	Славянский Кредит	2960	Москва и обл.	7076571	5803603	1272968	21.93
291	25	ОПМ-Банк	2734	Москва и обл.	7010054	5356793	1653261	30.86
292	-15	КС Банк	1752	Мордовия	6946621	6538377	408244	6.24
293	-38	Ставропольпромстройбанк	1288	Ставропольский край	6925919	7438322	-512403	-6.89
294	239	РосинтерБанк	226	Москва и обл.	6846253	1929354	4916899	254.85
295	-10	Япы Креди Банк Москва	2555	Москва и обл.	6813184	6337711	475473	7.5
296	38	Русский Ипотечный Банк	1968	Москва и обл.	6803201	4629282	2173919	46.96
297	45	Нико-Банк	702	Оренбургская обл.	6705296	4437265	2268031	51.11
298	6	Хованский	2145	Москва и обл.	6629592	5693496	936096	16.44
299	-55	Платежный Центр	3166	Новосибирская обл.	6618500	7842295	-1223795	-15.61
300	-37	Темпбанк	55	Москва и обл.	6608936	7068298	-459362	-6.5
301	-114	Банк Финсервис	3388	Москва и обл.	6567370	11784569	-5217199	-44.27
302	49	Росавтобанк	2767	Москва и обл.	6560108	4291509	2268599	52.86
303	-20	Русь	704	Оренбургская обл.	6527802	6362855	164947	2.59
304	7	Международный Коммерческий Банк	2524	Москва и обл.	6350312	5594729	755583	13.51
305	13	Финам Банк	2799	Москва и обл.	6289523	5328704	960819	18.03
306	51	Автоторгбанк	2776	Москва и обл.	6166570	4144060	2022510	48.81
307	-37	Банк Инноваций и Развития	2647	Москва и обл.	6163830	6821860	-658030	-9.65
308	130	Транснациональный Банк	2108	Москва и обл.	6089264	3017383	3071881	101.81
309	72	Банк БЦК-Москва	3480	Москва и обл.	6036158	3735674	2300484	61.58
310	-16	Томскпромстройбанк	1720	Томская обл.	6023707	5979141	44566	0.75
311	13	Тусар	2712	Москва и обл.	6018017	4930016	1088001	22.07
312	40	Солид Банк	1329	Камчатская обл.	6002551	4272077	1730474	40.51
313	-12	Волга-Кредит	1153	Самарская обл.	5993387	5774674	218713	3.79
314	-21	Югра	880	Тюменская обл.	5949431	6084436	-135005	-2.22
315	10	Ишбанк	2867	Москва и обл.	5918454	4877970	1040484	21.33
316	-19	Ижкомбанк	646	Удмуртия	5861333	5813218	48115	0.83
317	46	Уралкапиталбанк	2519	Башкортостан	5845210	4073397	1771813	43.5
318	15	Банк на Красных Воротах	2472	Москва и обл.	5803574	4657789	1145785	24.6
319	8	Банк Казани	708	Татарстан	5759637	4871768	887869	18.22
320	-6	Объединенный Банк Промышленных Инвестиций	2626	Москва и обл.	5752096	5446144	305952	5.62
321	1	Рускобанк	138	Санкт-Петербург и обл.	5742903	5110015	632888	12.39
322	-12	ПИР Банк	2655	Москва и обл.	5742261	5596326	145935	2.61
323	-14	Банк Оранжевый	1659	Санкт-Петербург и обл.	5725496	5609174	116322	2.07
324	-25	ПВ-Банк	634	Ульяновская обл.	5723371	5792668	-69297	-1.2
325	44	Миллениум Банк	3423	Москва и обл.	5686401	3948418	1737983	44.02
326	-6	Муниципальный Камчатпрофитбанк	2103	Камчатская обл.	5639883	5223753	416130	7.97
327	58	Веста	2368	Москва и обл.	5499041	3713584	1785457	48.08
328	1	Банк Торгового Финансирования	1982	Москва и обл.	5468516	4826225	642291	13.31
329	-79	Ю Би Эс Банк	3463	Москва и обл.	5451960	7641253	-2189293	-28.65
330	20	Монолит	1967	Москва и обл.	5444610	4309597	1135013	26.34
331	312	Бенифит-Банк	3229	Москва и обл.	5409799	1308972	4100827	313.29
332	34	Волжский Социальный Банк	2428	Самарская обл.	5388286	3989214	1399072	35.07
333	-16	Бинбанк Тверь	777	Тверская обл.	5334718	5338040	-3322	-0.06
334	-60	Славия	2664	Москва и обл.	5326801	6739750	-1412949	-20.96
335	62	Проминвестбанк	2433	Москва и обл.	5307678	3547502	1760176	49.62
336	35	Агросоюз	1459	Оренбургская обл.	5283778	3934571	1349207	34.29
337	-14	Потенциал	1019	Самарская обл.	5258990	5049479	209511	4.15
338	5	Автоградбанк	1455	Татарстан	5239464	4437247	802217	18.08
339	2	ЕвроситиБанк	1869	Ставропольский край	5168337	4440309	728028	16.4
340	-48	Альба Альянс	2593	Москва и обл.	5165756	6125938	-960182	-15.67
341	-52	Банк Раунд	2506	Москва и обл.	5155661	6221808	-1066147	-17.14
342	7	Трансстройбанк	2807	Москва и обл.	5120221	4311570	808651	18.76
343	3	Экспресс-Кредит	210	Москва и обл.	5094189	4375926	718263	16.41
344	-41	Бинбанк Мурманск	1276	Мурманская обл.	5037643	5745202	-707559	-12.32
345	-19	Северный Народный Банк	2721	Коми	5004159	4876780	127379	2.61
346	49	Экономикс-Банк	2136	Москва и обл.	4967207	3587190	1380017	38.47
347	14	ФДБ	3071	Москва и обл.	4921826	4107234	814592	19.83
348	-13	Юг-Инвестбанк	2772	Краснодарский край	4909469	4575927	333542	7.29
349	-61	Вега-Банк	3270	Москва и обл.	4898916	6233498	-1334582	-21.41
350	9	Национальный Залоговый Банк	2944	Москва и обл.	4826428	4111234	715194	17.4
351	-20	Сиббизнесбанк	2539	Тюменская обл.	4755799	4798767	-42968	-0.9
352	220	Фольксваген Банк Рус	3500	Москва и обл.	4740104	1669393	3070711	183.94
353	-32	Региональный Банк Развития	2782	Башкортостан	4715085	5140713	-425628	-8.28
354	-15	Актив Банк	2529	Мордовия	4697708	4453879	243829	5.47
355	32	Софрино	2972	Москва и обл.	4664704	3709445	955259	25.75
356	4	Кремлевский	2905	Москва и обл.	4646189	4107914	538275	13.1
357	21	Голдман Сакс Банк	3490	Москва и обл.	4641125	3803979	837146	22.01
358	40	Банкхаус Эрбе	1717	Москва и обл.	4576729	3540536	1036193	29.27
359	15	Стратегия	2801	Москва и обл.	4561399	3890841	670558	17.23
360	-123	Платина	2347	Москва и обл.	4534758	8164650	-3629892	-44.46
361	48	Ассоциация	732	Нижегородская обл.	4534019	3367212	1166807	34.65
362	332	Военно-Промышленный Банк	3065	Москва и обл.	4528003	1040915	3487088	335
363	-51	Генбанк	2490	Москва и обл.	4523158	5538353	-1015195	-18.33
364	22	Белгородпромстройбанк	1816	Белгородская обл.	4510832	3709951	800881	21.59
365	8	Чувашкредитпромбанк	1280	Чувашия	4504169	3909232	594937	15.22
366	-1	Промтрансбанк	2638	Башкортостан	4502366	3996932	505434	12.65
367	-9	Сибсоцбанк	2015	Алтайский край	4473097	4122349	350748	8.51
368	93	Аскольд	2480	Смоленская обл.	4472939	2676824	1796115	67.1
369	183	Ренессанс	1939	Москва и обл.	4441095	1788883	2652212	148.26
370	-16	Московский Нефтехимический Банк	1411	Москва и обл.	4436575	4185299	251276	6
371	127	Нэклис-Банк	1671	Москва и обл.	4426870	2315674	2111196	91.17
372	31	Лесбанк	1598	Москва и обл.	4426769	3460922	965847	27.91
373	21	Вокбанк	312	Нижегородская обл.	4419433	3587832	831601	23.18
374	386	Коммерческий Банк Развития	3364	Москва и обл.	4409714	759468	3650246	480.63
375	2	Дагэнергобанк	3286	Дагестан	4399249	3814586	584663	15.33
376	25	Дил-Банк	3384	Москва и обл.	4387097	3488998	898099	25.74
377	-32	Сибнефтебанк	385	Тюменская обл.	4383991	4382195	1796	0.04
378	-3	Витас Банк	1955	Москва и обл.	4368938	3861457	507481	13.14
379	12	Бинбанк Смоленск	1957	Смоленская обл.	4317164	3653557	663607	18.16
380	19	Анкор Банк	889	Татарстан	4302492	3519171	783321	22.26
381	85	Эксперт Банк	2949	Омская обл.	4269678	2647450	1622228	61.28
382	23	БайкалИнвестБанк	1067	Иркутская обл.	4254397	3439790	814607	23.68
383	1	Зернобанк	2337	Алтайский край	4217147	3724113	493034	13.24
384	35	Профит Банк	3234	Москва и обл.	4207427	3247519	959908	29.56
385	26	Банк Развития Технологий	3441	Москва и обл.	4200399	3328041	872358	26.21
387	6	Банк БКФ	2684	Москва и обл.	4165275	3622706	542569	14.98
388	67	ОФК Банк	2270	Москва и обл.	4148465	2724277	1424188	52.28
389	-110	Лада-Кредит	2668	Самарская обл.	4124069	6490906	-2366837	-36.46
390	-26	Хлебобанк	1812	Москва и обл.	4114722	4045848	68874	1.7
391	-55	Енисейский Объединенный Банк	2645	Красноярский край	4065281	4531666	-466385	-10.29
392	-37	Руссобанк	2313	Москва и обл.	4052463	4169210	-116747	-2.8
393	-14	Орловский Социальный Банк	2921	Орловская обл.	4045974	3801670	244304	6.43
394	-166	Свенска Хандельсбанкен	3455	Москва и обл.	4011505	8760507	-4749002	-54.21
395	-51	Башинвестбанк	2189	Башкортостан	4010178	4409009	-398831	-9.05
396	-6	ВостСибтранскомбанк	2731	Иркутская обл.	4007641	3658686	348955	9.54
397	150	Мой Банк. Ипотека	2436	Башкортостан	4004566	1821589	2182977	119.84
398	92	Клиентский	2324	Москва и обл.	3998866	2406012	1592854	66.2
399	18	Банк БФТ	2273	Москва и обл.	3943000	3271549	671451	20.52
400	-11	Банк Развития Региона	3315	Северная Осетия — Алания	3936420	3666046	270374	7.38
401	62	Банк Город	2644	Москва и обл.	3925979	2661948	1264031	47.49
402	-19	Межрегиональный промышленно-строительный банк	752	Мордовия	3906068	3725500	180568	4.85
403	44	Промэнергобанк	2728	Вологодская обл.	3899226	2862353	1036873	36.22
404	3	Новобанк	1352	Новгородская обл.	3836736	3377695	459041	13.59
405	-49	Риабанк	3434	Москва и обл.	3834727	4162794	-328067	-7.88
406	18	Камский Коммерческий Банк	438	Татарстан	3832112	3173619	658493	20.75
407	7	Промрегионбанк	2123	Томская обл.	3767447	3303507	463940	14.04
408	8	Нижневолжский Коммерческий Банк	931	Саратовская обл.	3741246	3287483	453763	13.8
409	39	Ураллига	1626	Челябинская обл.	3719691	2808895	910796	32.43
410	21	Торгово-Строительный Банк	1250	Москва и обл.	3701948	3094884	607064	19.62
411	153	Развитие	2729	Карачаево-Черкесия	3677845	1723755	1954090	113.36
412	-59	Тихоокеанский Внешторгбанк	1378	Сахалинская обл.	3639252	4266618	-627366	-14.7
413	-148	Русский Земельный Банк	2810	Москва и обл.	3637597	7021496	-3383899	-48.19
414	100	Русский Торговый Банк	2842	Москва и обл.	3637145	2091941	1545204	73.86
415	-23	Экси-Банк	2530	Санкт-Петербург и обл.	3635149	3638321	-3172	-0.09
416	-44	Донинвест	1617	Ростовская обл.	3634798	3921660	-286862	-7.31
417	42	Зенит Сочи	232	Краснодарский край	3619413	2687150	932263	34.69
418	-86	Заречье	817	Татарстан	3589668	4721507	-1131839	-23.97
419	-197	Юникорбанк	2586	Москва и обл.	3532057	9240064	-5708007	-61.77
420	102	Банк Расчетов и Сбережений	2617	Москва и обл.	3530686	2020269	1510417	74.76
421	5	Хакасский Муниципальный Банк	1049	Хакасия	3500782	3161618	339164	10.73
422	3	Донкомбанк	492	Ростовская обл.	3500623	3168716	331907	10.47
423	11	Ермак	1809	Тюменская обл.	3476006	3061530	414476	13.54
424	100	Спецсетьстройбанк	3062	Москва и обл.	3447273	1991754	1455519	73.08
425	-10	Кранбанк	2271	Ивановская обл.	3404120	3290381	113739	3.46
426	-4	Межрегиональный Почтовый Банк	3171	Москва и обл.	3388299	3193423	194876	6.1
427	76	Век	2299	Москва и обл.	3368932	2244988	1123944	50.06
428	30	Новопокровский	467	Краснодарский край	3357992	2690570	667422	24.81
429	-16	Горбанк	2982	Санкт-Петербург и обл.	3341379	3307303	34076	1.03
430	10	Интерактивный Банк	3378	Москва и обл.	3341145	2970513	370632	12.48
431	-13	Транспортный	3174	Москва и обл.	3321854	3253282	68572	2.11
432	17	Океан Банк	1697	Москва и обл.	3302088	2806041	496047	17.68
433	19	Джей энд Ти Банк	3061	Москва и обл.	3297336	2778430	518906	18.68
434	-22	Тюменьагропромбанк	917	Тюменская обл.	3273325	3317555	-44230	-1.33
435	-178	Банк Премьер Кредит	1663	Коми	3246308	7335366	-4089058	-55.74
436	-3	Инкаробанк	2696	Москва и обл.	3244296	3067913	176383	5.75
437	44	Нейва	1293	Свердловская обл.	3233780	2498292	735488	29.44
438	-62	Приоритет	3135	Самарская обл.	3232951	3821584	-588633	-15.4
439	-11	Баренцбанк	2188	Мурманская обл.	3218779	3121596	97183	3.11
440	-36	Евроальянс	1781	Ивановская обл.	3215421	3444993	-229572	-6.66
441	56	Финансовый Стандарт	1053	Москва и обл.	3193222	2341350	851872	36.38
442	-12	Уралпромбанк	2964	Челябинская обл.	3156317	3104118	52199	1.68
443	-8	2Т Банк	625	Москва и обл.	3153489	3040115	113374	3.73
444	142	Межтрастбанк	2493	Москва и обл.	3144629	1582790	1561839	98.68
445	-35	Тендер-Банк	2252	Москва и обл.	3123122	3337644	-214522	-6.43
446	137	Еврокоммерц	1777	Москва и обл.	3118030	1605192	1512838	94.25
447	3	ПК-Банк	2652	Нижегородская обл.	3102014	2786544	315470	11.32
448	34	Мастер-Капитал	3011	Москва и обл.	3086278	2497814	588464	23.56
449	-41	Наш Дом	3296	Москва и обл.	3083513	3368218	-284705	-8.45
450	-29	Бинбанк Сургут	1701	Тюменская обл.	3082225	3198912	-116687	-3.65
451	-51	Роял Кредит Банк	783	Хабаровский край	3059351	3511936	-452585	-12.89
452	-6	Стромкомбанк	404	Красноярский край	3049213	2916982	132231	4.53
453	-21	Камчаткомагропромбанк	545	Камчатская обл.	2992990	3087946	-94956	-3.08
454	0	Алтайкапиталбанк	2659	Алтайский край	2984462	2744374	240088	8.75
455	5	РБА	3413	Ярославская обл.	2982887	2686543	296344	11.03
456	-50	Азия-Инвест Банк	3303	Москва и обл.	2968551	3383159	-414608	-12.26
457	23	Мосводоканалбанк	2863	Москва и обл.	2964688	2505551	459137	18.32
458	-1	Ипотека-Инвест	3070	Татарстан	2942142	2700483	241659	8.95
459	-32	Преодоление	2649	Москва и обл.	2916513	3149395	-232882	-7.39
460	5	Сити Инвест Банк	3194	Санкт-Петербург и обл.	2906955	2654734	252221	9.5
461	23	Земский Банк	2900	Самарская обл.	2882308	2468451	413857	16.77
462	-23	Капитал	575	Москва и обл.	2871985	2991656	-119671	-4
463	31	Стройлесбанк	2995	Тюменская обл.	2860781	2377841	482940	20.31
464	-23	Нефтепромбанк	2156	Москва и обл.	2858692	2941977	-83285	-2.83
465	60	Еврокредит	2957	Москва и обл.	2827618	1990982	836636	42.02
466	9	Оргбанк	3312	Москва и обл.	2825186	2609999	215187	8.24
467	-14	Аспект	608	Москва и обл.	2803550	2753446	50104	1.82
468	82	Вэлтон Банк	1105	Белгородская обл.	2798687	1792379	1006308	56.14
469	35	Кузнецкий	609	Пензенская обл.	2788730	2244141	544589	24.27
470	-25	Первый Инвестиционный банк	604	Москва и обл.	2771019	2917930	-146911	-5.03
471	5	Нокссбанк	3202	Волгоградская обл.	2770745	2566930	203815	7.94
472	13	Траст Капитал Банк	2741	Москва и обл.	2758759	2457337	301422	12.27
473	-30	Интернациональный Торговый Банк	2609	Омская обл.	2757799	2929569	-171770	-5.86
474	106	Инвестиционный Союз	637	Москва и обл.	2733447	1625752	1107695	68.13
475	20	Союзный	3236	Москва и обл.	2732024	2371641	360383	15.2
476	26	Республиканский Банк	3277	Москва и обл.	2728196	2248434	479762	21.34
477	-3	Итуруп	2390	Сахалинская обл.	2727477	2615619	111858	4.28
478	13	Уралприватбанк	153	Свердловская обл.	2709806	2404616	305190	12.69
479	-15	Долинск	857	Сахалинская обл.	2689916	2659123	30793	1.16
480	-1	Живаго-Банк	2065	Рязанская обл.	2655674	2552012	103662	4.06
481	-58	Интеркредит	3047	Москва и обл.	2655566	3183951	-528385	-16.6
482	-11	Газстройбанк	2919	Москва и обл.	2655105	2633481	21624	0.82
483	68	Северный Кредит	2398	Вологодская обл.	2637739	1791834	845905	47.21
484	39	Синко-Банк	2838	Москва и обл.	2615717	2012508	603209	29.97
485	-56	ЕвроАксис Банк	3273	Москва и обл.	2603647	3115988	-512341	-16.44
486	59	Венец	524	Ульяновская обл.	2589186	1830664	758522	41.43
487	40	Витабанк	356	Санкт-Петербург и обл.	2582494	1986854	595640	29.98
488	-5	Универсальный Кредит	2903	Москва и обл.	2575736	2486174	89562	3.6
489	-121	Социум-Банк	2881	Москва и обл.	2575562	3965609	-1390047	-35.05
490	6	Москва-Сити	3247	Москва и обл.	2575132	2347271	227861	9.71
491	65	Гринфилдбанк	2711	Москва и обл.	2574284	1769483	804801	45.48
492	-14	Вкабанк	1027	Астраханская обл.	2572150	2556956	15194	0.59
493		ИпоТек Банк	2794	Москва и обл.	2572002			
494	-112	Лайтбанк	3177	Москва и обл.	2559043	3734841	-1175798	-31.48
495	-28	Тульский Промышленник	2382	Тульская обл.	2544316	2642519	-98203	-3.72
496	-9	Енисей	474	Красноярский край	2529709	2435313	94396	3.88
497	2	Тамбовкредитпромбанк	1312	Тамбовская обл.	2524392	2283533	240859	10.55
498	191	Межотраслевая Банковская Корпорация	3471	Москва и обл.	2518925	1052628	1466297	139.3
499	13	Региональный Кредитный Банк	1608	Калининградская обл.	2512439	2093869	418570	19.99
500	-8	Росбизнесбанк	1405	Москва и обл.	2511697	2389900	121797	5.1
501	-39	Объединенный Банк Развития	3345	Москва и обл.	2508065	2667231	-159166	-5.97
502	-122	Международный Инвестиционный Банк	2742	Москва и обл.	2496882	3747781	-1250899	-33.38
503	84	Татсоцбанк	480	Татарстан	2491331	1572747	918584	58.41
504	-60	Крыловский	456	Краснодарский край	2485137	2921878	-436741	-14.95
505	34	Профессионал Банк	2471	Москва и обл.	2478545	1903141	575404	30.23
506	-64	Российский Национальный Коммерческий Банк	1354	Москва и обл.	2476691	2940309	-463618	-15.77
507	-2	Система	2846	Москва и обл.	2461453	2235559	225894	10.1
508	-31	Гагаринский	606	Москва и обл.	2448332	2561078	-112746	-4.4
509	-73	Московский Коммерческий Банк	3172	Москва и обл.	2442820	3035785	-592965	-19.53
510	-10	Милбанк	3256	Москва и обл.	2442423	2263637	178786	7.9
511	44	Сберинвестбанк	1743	Свердловская обл.	2423494	1778288	645206	36.28
512	113	Национальный Банк Сбережений	1949	Ивановская обл.	2411825	1391760	1020065	73.29
513	24	Мосуралбанк	2468	Москва и обл.	2410800	1915569	495231	25.85
514	-6	Вологжанин	1896	Вологодская обл.	2397205	2147630	249575	11.62
515	-145	Севзапинвестпромбанк	2152	Санкт-Петербург и обл.	2389330	3939840	-1550510	-39.35
516	37	Костромаселькомбанк	1115	Костромская обл.	2388408	1784818	603590	33.82
517	-16	Уссури	596	Хабаровский край	2384211	2262643	121568	5.37
518	-257	Киви Банк	2241	Москва и обл.	2370125	7163637	-4793512	-66.91
519	119	Консервативный Коммерческий Банк	1087	Астраханская обл.	2368632	1325004	1043628	78.76
520	29	Форус Банк	3457	Нижегородская обл.	2341741	1804953	536788	29.74
521	-35	ИРС	272	Москва и обл.	2334780	2447354	-112574	-4.6
522	-33	Совинком	2302	Москва и обл.	2332308	2414451	-82143	-3.4
523	-5	Агророс	2860	Саратовская обл.	2323098	2069515	253583	12.25
524	6	Финансовый Капитал	3288	Санкт-Петербург и обл.	2313198	1944570	368628	18.96
525	93	Контраст-Банк	2857	Москва и обл.	2280320	1440509	839811	58.3
526	0	Аксонбанк	680	Костромская обл.	2277753	1988595	289158	14.54
527	36	Банк ИТБ	3128	Москва и обл.	2277011	1724489	552522	32.04
528	64	Банк РМП	2574	Москва и обл.	2258041	1546370	711671	46.02
529	-19	Коммерческий Индо Банк	3446	Москва и обл.	2176941	2135738	41203	1.93
530	37	Резерв	2364	Челябинская обл.	2163521	1684789	478732	28.41
531	-18	Бум-Банк	1137	Кабардино-Балкария	2155200	2092473	62727	3
532	-64	Тагилбанк	1635	Свердловская обл.	2148510	2642011	-493501	-18.68
533	113	Русский Трастовый Банк	1139	Москва и обл.	2121280	1280640	840640	65.64
534	-65	Союзпромбанк	2965	Москва и обл.	2103510	2639757	-536247	-20.31
535	66	Интеркапитал-Банк	2706	Мордовия	2088464	1505261	583203	38.74
536	-21	Новый Символ	370	Москва и обл.	2087599	2088335	-736	-0.04
537	61	Финансово-Промышленный Капитал	3295	Москва и обл.	2076549	1515799	560750	36.99
538	-18	Финтрастбанк	3104	Москва и обл.	2070371	2062816	7555	0.37
539	-28	Банк Экономический Союз	2798	Москва и обл.	2067767	2123434	-55667	-2.62
540	-24	Констанс-Банк	2228	Санкт-Петербург и обл.	2037562	2082240	-44678	-2.15
541	-34	РН Банк	170	Омская обл.	2032059	2170774	-138715	-6.39
542	119	Богородский	1277	Нижегородская обл.	2029493	1224337	805156	65.76
543	0	Таатта	1249	Саха (Якутия)	2025683	1840506	185177	10.06
544	-27	НБК-Банк	3283	Москва и обл.	2024923	2079325	-54402	-2.62
545	-16	ИК Банк	1732	Татарстан	2019949	1982622	37327	1.88
546	15	Братский АНКБ	1144	Иркутская обл.	1997889	1741454	256435	14.73
547	-26	Невский Банк	1068	Санкт-Петербург и обл.	1986977	2040865	-53888	-2.64
548	23	Кубанский Универсальный Банк	2898	Краснодарский край	1981610	1677602	304008	18.12
549	8	Липецкий Областной Банк	1794	Липецкая обл.	1949817	1766722	183095	10.36
550	57	Банк МБФИ	2073	Москва и обл.	1948282	1475847	472435	32.01
551	-9	Пермь	875	Пермская обл.	1947249	1867360	79889	4.28
552	-24	Яринтербанк	2564	Ярославская обл.	1946893	1986713	-39820	-2
553	12	Мегаполис	3265	Чувашия	1940134	1722577	217557	12.63
554	8	Новокиб	1747	Кемеровская обл.	1935244	1728317	206927	11.97
555	-14	Стелла-Банк	2948	Ростовская обл.	1933080	1869829	63251	3.38
556	-22	Донхлеббанк	2285	Ростовская обл.	1923635	1927012	-3377	-0.18
557	19	РСКБ	2050	Москва и обл.	1922967	1658721	264246	15.93
558	1	Кросна-Банк	2607	Москва и обл.	1915506	1757294	158212	9
559	22	Смартбанк	3408	Москва и обл.	1908714	1618949	289765	17.9
560	-6	Выборг-Банк	720	Санкт-Петербург и обл.	1905171	1784759	120412	6.75
561	32	Мобилбанк	532	Удмуртия	1904984	1543368	361616	23.43
562	37	Дом-Банк	3209	Москва и обл.	1881647	1515033	366614	24.2
563	100	Арксбанк	1868	Москва и обл.	1873979	1222322	651657	53.31
564	6	МФБанк	3163	Москва и обл.	1867939	1678688	189251	11.27
565	-25	Юнистрим	3467	Москва и обл.	1866198	1879192	-12994	-0.69
566	-20	ФорБанк	2063	Алтайский край	1865328	1829498	35830	1.96
567	35	Приско Капитал Банк	2537	Москва и обл.	1857001	1494241	362760	24.28
568	41	Пульс Столицы	3002	Москва и обл.	1856882	1473119	383763	26.05
569	0	Газнефтьбанк	3223	Саратовская обл.	1848392	1680199	168193	10.01
570	125	Сибирский Банк Реконструкции и Развития	1284	Тюменская обл.	1847138	1040549	806589	77.52
571	-36	Кроссинвестбанк	2849	Москва и обл.	1822778	1920189	-97411	-5.07
572	22	Радиотехбанк	1166	Нижегородская обл.	1818002	1542523	275479	17.86
573	-37	Россита-Банк	3257	Москва и обл.	1816160	1919865	-103705	-5.4
574	14	Уралфинанс	1370	Свердловская обл.	1815568	1559121	256447	16.45
575	25	Объединенный Резервный Банк	937	Москва и обл.	1809679	1508505	301174	19.97
576	58	Ваш Личный Банк	1222	Иркутская обл.	1799363	1344510	454853	33.83
577	27	Михайловский ПЖСБ	2961	Волгоградская обл.	1796892	1491296	305596	20.49
578	34	Зираат Банк	2559	Москва и обл.	1794305	1462361	331944	22.7
579	-19	Новый Век	3417	Москва и обл.	1787974	1756788	31186	1.78
580	-12	Владпромбанк	870	Владимирская обл.	1759815	1682127	77688	4.62
581	32	Витязь	2890	Москва и обл.	1759740	1460182	299558	20.52
582	13	КОР	2148	Волгоградская обл.	1749118	1542510	206608	13.39
583	1	Новация	840	Адыгея	1746550	1598037	148513	9.29
584	6	Йошкар-Ола	2802	Марий Эл	1744248	1550385	193863	12.5
585	-41	Компания Розничного Кредитования	3385	Москва и обл.	1737474	1840486	-103012	-5.6
586	-114	Объединенная Расчетная Система	3342	Москва и обл.	1718892	2633259	-914367	-34.72
587	18	Мираф-Банк	2244	Омская обл.	1713264	1481912	231352	15.61
588	20	Земкомбанк	574	Ростовская обл.	1711352	1474300	237052	16.08
589	-4	Ринвестбанк	3262	Рязанская обл.	1710171	1586995	123176	7.76
590	47	Старооскольский Агропромбанк	1050	Белгородская обл.	1706645	1327358	379287	28.57
591	28	Вестерн Юнион ДП Восток	2726	Москва и обл.	1706097	1438501	267596	18.6
592	-44	Эсидбанк	1991	Дагестан	1689764	1811429	-121665	-6.72
593	17	Спиритбанк	2053	Тульская обл.	1681883	1468698	213185	14.52
594	114	Евразийский Банк	969	Москва и обл.	1678937	991595	687342	69.32
595	-4	Современные Стандарты Бизнеса	3397	Москва и обл.	1678161	1546789	131372	8.49
596	-30	Иваново	1763	Ивановская обл.	1675930	1714939	-39009	-2.27
597	130	Верхневолжский	1084	Ярославская обл.	1662985	894117	768868	85.99
598	49	Диг-Банк	2423	Северная Осетия — Алания	1656012	1275309	380703	29.85
599	93	Сталь Банк	2248	Москва и обл.	1635529	1041940	593589	56.97
600	28	Объединенный Банк Республики	1016	Чувашия	1632776	1374407	258369	18.8
601	16	Уральский Межрегиональный Банк	1441	Свердловская обл.	1629354	1445892	183462	12.69
602	83	Апабанк	2404	Москва и обл.	1595589	1071537	524052	48.91
603	63	Пурпе	709	Тюменская обл.	1577932	1203110	374822	31.15
604	-26	Соколовский	2830	Москва и обл.	1576506	1636943	-60437	-3.69
605	231	Эл Банк	1025	Республика Алтай	1571127	515208	1055919	204.95
606	130	Финанс Бизнес Банк	520	Краснодарский край	1568656	874109	694547	79.46
607	8	Татагропромбанк	728	Татарстан	1562584	1454149	108435	7.46
608	-29	Нальчик	695	Кабардино-Балкария	1556978	1633778	-76800	-4.7
609	94	Мострансбанк	2258	Москва и обл.	1545783	1005134	540649	53.79
610	23	Холмск	503	Сахалинская обл.	1544959	1350540	194419	14.4
611	31	Элита	1399	Калужская обл.	1541790	1309930	231860	17.7
612	70	Промсельхозбанк	538	Москва и обл.	1541351	1096133	445218	40.62
613	3	Спутник	1071	Оренбургская обл.	1536975	1451418	85557	5.89
614	16	Новое Время	3492	Москва и обл.	1536026	1363227	172799	12.68
615	34	Нерюнгрибанк	825	Саха (Якутия)	1532283	1270759	261524	20.58
616	-2	Торжокуниверсалбанк	933	Тверская обл.	1531632	1455920	75712	5.2
617	-43	Далетбанк	3049	Москва и обл.	1529967	1664352	-134385	-8.07
618	-21	Викинг	2	Санкт-Петербург и обл.	1522939	1522290	649	0.04
619	-13	Саратов	330	Саратовская обл.	1507817	1478666	29151	1.97
620	34	БСТ-Банк	2883	Кемеровская обл.	1489678	1244010	245668	19.75
621	97	Крона-Банк	2499	Иркутская обл.	1485747	957682	528065	55.14
622	0	Владбизнесбанк	903	Владимирская обл.	1483240	1405868	77372	5.5
623	33	Арт-Банк	2779	Северная Осетия — Алания	1465164	1242319	222845	17.94
624	35	Сервис-Резерв	2034	Москва и обл.	1459989	1227495	232494	18.94
625	16	Навигатор	2469	Москва и обл.	1458096	1314408	143688	10.93
626	-6	Приобье	537	Тюменская обл.	1456828	1424452	32376	2.27
627	48	РТС-Банк	3401	Самарская обл.	1452176	1156123	296053	25.61
628	29	Новый Промышленный Банк	930	Москва и обл.	1447966	1238981	208985	16.87
629	307	Церих	3278	Орловская обл.	1447096	234298	1212798	517.63
630	5	Нарат	1902	Саратовская обл.	1445985	1329798	116187	8.74
631	-180	ВЕБРР	3418	Москва и обл.	1438115	2780706	-1342591	-48.28
632	26	Екатерининский	2167	Москва и обл.	1424272	1235252	189020	15.3
633	12	Интеркоопбанк	2803	Москва и обл.	1423733	1283615	140118	10.92
634	-11	Столичный Кредит	2853	Москва и обл.	1422238	1401074	21164	1.51
635	-77	Межрегионбанк	1059	Москва и обл.	1415339	1763377	-348038	-19.74
636	-9	Республиканский Кредитный Альянс	3017	Москва и обл.	1414758	1382438	32320	2.34
637	-11	Вологдабанк	992	Вологодская обл.	1414357	1384557	29800	2.15
638	-250	Европлан Банк	3052	Москва и обл.	1413151	3683409	-2270258	-61.63
639	-50	Уральский Трастовый Банк	2523	Удмуртия	1412839	1552300	-139461	-8.98
640	62	Проинвестбанк	784	Пермская обл.	1412406	1006999	405407	40.26
641	-68	Национальный Банк Взаимного Кредита	3214	Москва и обл.	1398182	1667763	-269581	-16.16
642	2	Единственный	3187	Москва и обл.	1396989	1304596	92393	7.08
643	43	Примтеркомбанк	21	Приморский край	1396757	1065770	330987	31.06
644	47	Кемсоцинбанк	96	Кемеровская обл.	1396015	1046867	349148	33.35
645	-63	РЕСО Кредит	3450	Москва и обл.	1391084	1617754	-226670	-14.01
646	64	Саммит Банк	85	Приморский край	1389185	985943	403242	40.9
647	96	БВА Банк	1684	Москва и обл.	1383618	853823	529795	62.05
648	183	Адам Интернэшнл	2232	Дагестан	1381225	524439	856786	163.37
649	-53	Национальный Корпоративный Банк	3422	Москва и обл.	1379170	1532858	-153688	-10.03
650	-11	Великие Луки Банк	598	Псковская обл.	1372317	1322370	49947	3.78
651	-132	Кредитинвест	1197	Дагестан	1371324	2068584	-697260	-33.71
652	45	Байкалкредобанк	2990	Иркутская обл.	1369195	1028795	340400	33.09
653	-165	Национальный Республиканский Банк	3359	Москва и обл.	1364890	2419215	-1054325	-43.58
654	1	Геленджик-Банк	790	Краснодарский край	1353825	1242741	111084	8.94
655	111	Объединенный Кредитный Банк	1118	Владимирская обл.	1336803	739475	597328	80.78
656	18	Новый Кредитный Союз	3139	Москва и обл.	1334759	1157359	177400	15.33
657	-33	Златкомбанк	568	Москва и обл.	1328084	1398314	-70230	-5.02
658	23	Богородский Муниципальный Банк	2992	Москва и обл.	1325779	1097075	228704	20.85
659	13	Флора-Москва	533	Москва и обл.	1319486	1166423	153063	13.12
660	104	Конфидэнс Банк	970	Костромская обл.	1317577	745912	571665	76.64
661	-84	Московско-Парижский Банк	2646	Москва и обл.	1313240	1650414	-337174	-20.43
662	3	Приполярком	507	Тюменская обл.	1311524	1204974	106550	8.84
663	-23	Тандем	1951	Москва и обл.	1301774	1315566	-13792	-1.05
664	-61	Азимут	3154	Москва и обл.	1294672	1493441	-198769	-13.31
665	11	Риал-Кредит	3393	Москва и обл.	1286731	1154628	132103	11.44
666	13	Гринкомбанк	1184	Иркутская обл.	1286058	1106160	179898	16.26
667	37	Инбанк	1829	Москва и обл.	1274903	1000541	274362	27.42
668	-1	Торговый Городской Банк	3180	Тверская обл.	1270514	1199195	71319	5.95
669	0	Эргобанк	2856	Москва и обл.	1256930	1191850	65080	5.46
670	8	Метрополь	1639	Москва и обл.	1253996	1110725	143271	12.9
671	149	Северо-Западный 1 Альянс Банк	766	Санкт-Петербург и обл.	1252395	562821	689574	122.52
672	1	Регионфинансбанк	3357	Москва и обл.	1248318	1159476	88842	7.66
673	-13	Эльбин	2267	Дагестан	1241203	1225028	16175	1.32
674	35	Межрегиональный Клиринговый Банк	2543	Москва и обл.	1239108	989342	249766	25.25
675	-46	Охотный Ряд	3375	Москва и обл.	1230722	1363961	-133239	-9.77
676	104	Кредит Экспресс	3186	Ростовская обл.	1220007	670653	549354	81.91
677	7	Бумеранг	1002	Вологодская обл.	1207923	1081357	126566	11.7
678	-8	Сембанк	2606	Москва и обл.	1204352	1187577	16775	1.41
679	20	Русский Элитарный Банк	3231	Москва и обл.	1201037	1019323	181714	17.83
680	39	Вэлкомбанк	589	Ставропольский край	1190877	957162	233715	24.42
681	91	РФИ Банк	3351	Москва и обл.	1188151	713618	474533	66.5
682	41	Тайм Банк	3120	Москва и обл.	1185791	913962	271829	29.74
683	31	Стройиндбанк	155	Москва и обл.	1179700	972060	207640	21.36
684	49	Сельмашбанк	106	Ростовская обл.	1179658	882638	297020	33.65
685	3	Радиан	1675	Иркутская обл.	1167645	1061635	106010	9.99
686	-24	Металлург	2877	Москва и обл.	1162944	1223060	-60116	-4.92
687	148	Америкэн Экспресс Банк	3460	Москва и обл.	1156580	515529	641051	124.35
688	32	Сибэс	208	Омская обл.	1156277	953863	202414	21.22
689	18	Дон-Тексбанк	1818	Ростовская обл.	1151783	992013	159770	16.11
690	80	Бизнес для Бизнеса	1060	Чувашия	1139233	716011	423222	59.11
691	51	Кредитимпэкс Банк	2037	Москва и обл.	1130991	854138	276853	32.41
692	-21	КИП-Банк	2843	Москва и обл.	1113166	1167422	-54256	-4.65
693	116	МС Банк Рус	2789	Москва и обл.	1109701	593914	515787	86.85
694	23	Майкопбанк	1136	Адыгея	1105765	962356	143409	14.9
695	3	Калуга	1151	Калужская обл.	1102650	1026858	75792	7.38
696	-19	Трастовый Республиканский Банк	3404	Москва и обл.	1098682	1139264	-40582	-3.56
697	-33	Санкт-Петербургский Банк Инвестиций	3468	Санкт-Петербург и обл.	1092460	1210916	-118456	-9.78
698	15	Жилкредит	1736	Москва и обл.	1083331	972297	111034	11.42
699	226	Сибирский Энергетический Банк	2604	Москва и обл.	1069464	260789	808675	310.09
700	-13	Ганзакомбанк	1734	Санкт-Петербург и обл.	1069229	1063588	5641	0.53
701	10	Русский Национальный Банк	469	Ростовская обл.	1063695	977040	86655	8.87
702	52	Динамичные Системы	3439	Москва и обл.	1061655	787221	274434	34.86
703	19	Синергия	2884	Саратовская обл.	1055909	918207	137702	15
704	53	Булгар Банк	1917	Татарстан	1050007	780660	269347	34.5
705	25	Северинвестбанк	2264	Белгородская обл.	1036115	887517	148598	16.74
706	-174	Бест Эффортс Банк	435	Москва и обл.	1031597	1933742	-902145	-46.65
707	-14	Московский Вексельный Банк	2697	Москва и обл.	1024605	1041800	-17195	-1.65
708	86	Региональный Банк Сбережений	3367	Москва и обл.	1022337	628459	393878	62.67
709	-9	Рублевский	2192	Москва и обл.	1018655	1014512	4143	0.41
710	19	Максима	3379	Москва и обл.	1016647	887764	128883	14.52
711	47	Трансэнергобанк	3106	Дагестан	1014855	763691	251164	32.89
712	-44	Акрополь	3027	Москва и обл.	1012499	1193193	-180694	-15.14
713	11	Онего	2484	Карелия	987097	905702	81395	8.99
714	18	Первоуральскбанк	965	Свердловская обл.	982355	884316	98039	11.09
715	-35	Унифондбанк	3416	Москва и обл.	973912	1103099	-129187	-11.71
716	12	Банкирский Дом	2928	Санкт-Петербург и обл.	973799	892936	80863	9.06
717	38	Смолевич	1121	Смоленская обл.	971500	785537	185963	23.67
718	27	Канский	860	Красноярский край	968231	846717	121514	14.35
719	37	Мурманский Социальный Коммерческий Банк	2722	Мурманская обл.	967487	783528	183959	23.48
720	28	Кетовский Коммерческий Банк	842	Курганская обл.	964539	836351	128188	15.33
721	-15	Руна-Банк	3207	Москва и обл.	964467	992861	-28394	-2.86
722	52	Турбобанк	3203	Санкт-Петербург и обл.	961655	702079	259576	36.97
723	45	Симбирск	653	Ульяновская обл.	957244	725354	231890	31.97
724	14	Сургутский Центральный Коммерческий Банк	684	Тюменская обл.	953454	869548	83906	9.65
725	79	Расчетный Дом	3350	Москва и обл.	953264	607858	345406	56.82
726	88	ИстКом-Финанс	3435	Москва и обл.	948421	580314	368107	63.43
727	165	Идея Банк	430	Краснодарский край	947545	341267	606278	177.66
728	-12	Содружество	2923	Москва и обл.	944672	965599	-20927	-2.17
729	-28	Аскания Траст	286	Москва и обл.	939315	1009652	-70337	-6.97
730	19	Инвест-Экобанк	1956	Санкт-Петербург и обл.	930875	831648	99227	11.93
731	38	Восточно-Европейский Трастовый Банк	2253	Москва и обл.	928795	723096	205699	28.45
732	83	Академический Русский Банк	622	Москва и обл.	918676	573620	345056	60.15
733	96	Глобус	2438	Москва и обл.	917741	537475	380266	70.75
734	37	Тетраполис	1586	Санкт-Петербург и обл.	914332	714556	199776	27.96
735	-14	Анелик РУ	3443	Москва и обл.	913473	935271	-21798	-2.33
736	-10	Алтынбанк	2070	Татарстан	911835	896623	15212	1.7
737	-47	Народный Доверительный Банк	2374	Москва и обл.	909667	1047876	-138209	-13.19
738	3	Первый Дортрансбанк	3271	Кировская обл.	897999	854454	43545	5.1
739	-107	Центрально-Азиатский	3037	Хакасия	896102	1353143	-457041	-33.78
740	7	Далена	1948	Москва и обл.	895643	841313	54330	6.46
741	42	Идеалбанк	3491	Москва и обл.	894440	658427	236013	35.84
742	43	Курган	2568	Курганская обл.	892720	648252	244468	37.71
743	-92	Башпромбанк	1006	Башкортостан	884224	1255808	-371584	-29.59
744	0	ЕАТП Банк	1765	Астраханская обл.	881854	851513	30341	3.56
745	60	Народный Банк	2249	Карачаево-Черкесия	874705	606292	268413	44.27
746	56	Мурманский Расчетный Центр	3341	Мурманская обл.	873319	611931	261388	42.72
747	4	Бузулукбанк	1282	Оренбургская обл.	869185	813330	55855	6.87
748	31	Финарс Банк	2938	Москва и обл.	862963	676926	186037	27.48
749	51	Вакобанк	1291	Псковская обл.	857279	619514	237765	38.38
750	-114	Местный Кредит	3370	Москва и обл.	852974	1329532	-476558	-35.84
751	-20	Спецстройбанк	236	Москва и обл.	851575	885807	-34232	-3.86
752	-18	Международный Расчетный Банк	3028	Москва и обл.	841241	879476	-38235	-4.35
753	-41	Ноосфера	2650	Республика Алтай	839883	974483	-134600	-13.81
754	47	Космос	2245	Москва и обл.	834218	618850	215368	34.8
755	4	Почтобанк	1788	Пермская обл.	827909	759657	68252	8.98
756	11	Жилстройбанк	2769	Москва и обл.	825219	736610	88609	12.03
757	-52	Тексбанк	2756	Карачаево-Черкесия	818783	995858	-177075	-17.78
758	65	Первый Клиентский Банк	3436	Москва и обл.	812998	560920	252078	44.94
759	-20	Объединенный Капитал	2611	Санкт-Петербург и обл.	809569	862895	-53326	-6.18
760	18	Прайм Финанс	2758	Санкт-Петербург и обл.	806491	677809	128682	18.98
761	113	Си Ди Би Банк	3339	Краснодарский край	804148	401914	402234	100.08
762	29	Арзамас	1281	Нижегородская обл.	796788	630213	166575	26.43
763	10	Химик	1114	Нижегородская обл.	794752	704924	89828	12.74
764	-111	Арсенал	3000	Москва и обл.	789558	1244116	-454558	-36.54
765	-2	Месед	184	Дагестан	786364	746800	39564	5.3
766	-29	Одинбанк	3197	Москва и обл.	784671	872653	-87982	-10.08
767	-17	Аделантбанк	1835	Москва и обл.	780546	818294	-37748	-4.61
768	31	Евроазиатский Инвестиционный Банк	2897	Москва и обл.	767106	619833	147273	23.76
769	-29	Балаково-Банк	444	Саратовская обл.	764969	860205	-95236	-11.07
770	-17	Лето Банк	650	Брянская обл.	762208	795352	-33144	-4.17
771	102	Природа	3399	Москва и обл.	747752	407481	340271	83.51
772	107	Айви Банк	2055	Москва и обл.	740400	390869	349531	89.42
773	30	Кузбассхимбанк	2868	Кемеровская обл.	732414	608780	123634	20.31
774	138	Леноблбанк	1003	Санкт-Петербург и обл.	725632	286803	438829	153.01
775	2	Атлас Банк	3477	Москва и обл.	722666	685219	37447	5.46
776	34	Инвестсоцбанк	3010	Москва и обл.	718954	593241	125713	21.19
777	-94	Рапида	3371	Москва и обл.	717992	1093469	-375477	-34.34
778	8	Камчатка	2966	Камчатская обл.	717213	643908	73305	11.38
779	117	Ипозембанк	3026	Самарская обл.	714257	332940	381317	114.53
780	10	Русский Банк Сбережений	779	Ставропольский край	707940	630326	77614	12.31
781	38	Мико-Банк	3195	Москва и обл.	704948	563145	141803	25.18
782	14	Центрально-Европейский Банк	2670	Москва и обл.	697175	624628	72547	11.61
783	73	Народный Земельно-Промышленный Банк	2873	Алтайский край	690322	457186	233136	50.99
784	0	Взаимодействие	1704	Новосибирская обл.	689432	651790	37642	5.78
785	-24	МТИ-Банк	1052	Москва и обл.	689392	758199	-68807	-9.08
786	91	Региональный Коммерческий Банк	836	Ульяновская обл.	678188	391254	286934	73.34
787	-25	НоваховКапиталБанк	635	Москва и обл.	674741	748350	-73609	-9.84
788	5	Ростфинанс	481	Ростовская обл.	672039	628743	43296	6.89
789	37	Южный Региональный Банк	3015	Ростовская обл.	663971	544200	119771	22.01
790	-138	Славянбанк	804	Новгородская обл.	663242	1246260	-583018	-46.78
791	107	ВРБ Москва	3499	Москва и обл.	656886	329054	327832	99.63
792	33	Кредитбанк	1035	Калмыкия	654864	544801	110063	20.2
793	14	Тульский Расчетный Центр	3380	Тульская обл.	652035	596339	55696	9.34
794	51	РУБанк	2813	Ростовская обл.	650373	482279	168094	34.85
795	13	Классик Эконом Банк	3298	Северная Осетия — Алания	639768	595432	44336	7.45
796	1	Кутузовский	3190	Москва и обл.	639410	622617	16793	2.7
797	52	Московский Национальный Инвестиционный Банк	3181	Москва и обл.	638808	471485	167323	35.49
798	-10	РусьРегионБанк	685	Москва и обл.	636164	635163	1001	0.16
799	49	Банк ВВБ	1093	Ярославская обл.	635234	474101	161133	33.99
800	43	Инвестиционный Республиканский Банк	2571	Москва и обл.	627363	483754	143609	29.69
801	57	Сетевая Расчетная Палата	3332	Татарстан	625795	453554	172241	37.98
802	-50	Москва	1661	Москва и обл.	623489	806975	-183486	-22.74
803	19	Прохладный	874	Кабардино-Балкария	621636	561310	60326	10.75
804	60	Акция	927	Ивановская обл.	620788	438588	182200	41.54
805	-24	Ресурс-Траст	3122	Москва и обл.	619566	670303	-50737	-7.57
806	24	Кубаньторгбанк	478	Краснодарский край	618663	533950	84713	15.87
807	-18	Центр Межбанковских Расчетов	3400	Москва и обл.	617044	630617	-13573	-2.15
808	96	Газтрансбанк	665	Адыгея	616279	312509	303770	97.2
809	-84	Агроинкомбанк	1946	Астраханская обл.	613851	901032	-287181	-31.87
810	7	Геобанк	2027	Москва и обл.	599709	566138	33571	5.93
811	-29	Вестинтербанк	3398	Москва и обл.	592705	668327	-75622	-11.32
812	-17	Акцент	696	Оренбургская обл.	589475	626839	-37364	-5.96
813	3	Старый Кремль	2657	Москва и обл.	588030	566624	21406	3.78
814	-1	ОЛМА-Банк	3250	Москва и обл.	587099	580452	6647	1.15
815	18	НСТ-Банк	1738	Оренбургская обл.	551938	521293	30645	5.88
816	8	Московский Клиринговый Центр	3314	Москва и обл.	547141	557956	-10815	-1.94
817	-11	Дагестан	543	Дагестан	545436	606096	-60660	-10.01
818	-7	Тревел Банк	531	Москва и обл.	540945	587861	-46916	-7.98
819	-123	Бринкс	3486	Москва и обл.	539474	1028921	-489447	-47.57
820	-8	Северная Клиринговая Палата	3317	Архангельская обл.	538774	584163	-45389	-7.77
821	33	Анджибанк	570	Дагестан	537805	458230	79575	17.37
822	112	Линк-Банк	2699	Москва и обл.	537587	240473	297114	123.55
823	4	Алданзолотобанк	854	Саха (Якутия)	534426	540865	-6439	-1.19
824	44	Вятич	2796	Рязанская обл.	526787	428960	97827	22.81
825	15	Прокоммерцбанк	2996	Москва и обл.	526056	496491	29565	5.95
826	26	Миръ	3089	Москва и обл.	512835	466365	46470	9.96
827	34	Плато-Банк	2071	Свердловская обл.	506327	445844	60483	13.57
828	-7	Промышленно-Финансовое Сотрудничество	2410	Москва и обл.	503562	561570	-58008	-10.33
829	137	Трастовый Банк	2780	Дагестан	498707	142798	355909	249.24
830	-43	Сунжа	2023	Ингушетия	494680	642996	-148316	-23.07
831	16	Стар Альянс	3433	Москва и обл.	494406	475474	18932	3.98
832	58	Надежность	2425	Курганская обл.	492703	348200	144503	41.5
833	82	Объединенный Национальный Банк	2074	Москва и обл.	490767	280418	210349	75.01
834	35	Платежный Сервисный Банк	1943	Башкортостан	490617	425439	65178	15.32
835	60	Таурус Банк	655	Челябинская обл.	488496	332998	155498	46.7
836	-44	Ауэрбанк	3105	Москва и обл.	484598	629764	-145166	-23.05
837	43	Евросиб Банк	594	Псковская обл.	483996	389038	94958	24.41
838	-92	Эко-Инвест	3116	Москва и обл.	478770	842952	-364182	-43.2
839	0	Конгресс-Банк	2330	Москва и обл.	469901	499664	-29763	-5.96
840	69	Махачкалинский Городской Муниципальный Банк	3192	Дагестан	462917	305650	157267	51.45
841	0	Принтбанк	546	Москва и обл.	460903	496352	-35449	-7.14
842	11	Иронбанк	1724	Москва и обл.	459897	462066	-2169	-0.47
843	45	Дружба	990	Тюменская обл.	457302	350034	107268	30.65
844	-6	Далта-Банк	142	Приморский край	457269	511195	-53926	-10.55
845	40	Европейский Индустриальный Банк	2503	Москва и обл.	454495	351736	102759	29.21
846	24	Русский Финансовый Альянс	2035	Москва и обл.	452168	418578	33590	8.02
847	15	Банк Развития Бизнеса	1910	Кемеровская обл.	451345	444386	6959	1.57
848	59	Международный Строительный Банк	3484	Москва и обл.	450495	308448	142047	46.05
849	114	Нафтабанк	715	Дагестан	448225	157817	290408	184.02
850	78	Внешфинбанк	3173	Дагестан	447002	254485	192517	75.65
851	72	Информпрогресс	2166	Москва и обл.	445353	264546	180807	68.35
852	7	Промсвязьинвест	2761	Дагестан	442986	449336	-6350	-1.41
853	-7	Индустриальный Сберегательный Банк	3175	Москва и обл.	440699	481941	-41242	-8.56
854	1	Расчетная Палата СВМБ	3324	Самарская обл.	438272	457291	-19019	-4.16
855	12	Анталбанк	3115	Москва и обл.	433888	430081	3807	0.89
856	-6	НКБ	2942	Калмыкия	432907	470334	-37427	-7.96
857	37	Регнум	3373	Москва и обл.	427605	333443	94162	28.24
858	14	Имбанк	2098	Дагестан	427281	409396	17885	4.37
859	52	Майский	1673	Кабардино-Балкария	424795	289036	135759	46.97
860	71	ЮМК	3495	Краснодарский край	424613	246366	178247	72.35
861	26	Кредпромбанк	1165	Ярославская обл.	424383	351038	73345	20.89
862	62	Российская Финансовая Корпорация	3099	Москва и обл.	424282	261643	162639	62.16
863	76	Стандарт-Кредит	841	Адыгея	422101	230377	191724	83.22
864	-1	Гефест	1046	Тверская обл.	420079	438949	-18870	-4.3
865	-23	Новый Коммерческий Банк	347	Дагестан	414483	485444	-70961	-14.62
866	-6	Заубер Банк	1614	Карачаево-Черкесия	410874	446965	-36091	-8.07
867	76	Строительно-Коммерческий Банк	3050	Архангельская обл.	408814	217754	191060	87.74
868	32	Холдинвестбанк	2837	Москва и обл.	408455	323765	84690	26.16
869	7	Банк РСИ	3415	Москва и обл.	403945	398722	5223	1.31
870	57	Тальменка-Банк	826	Алтайский край	403371	255547	147824	57.85
871	30	Камский Горизонт	2554	Татарстан	401488	318315	83173	26.13
872	54	Европейский Стандарт	3200	Кабардино-Балкария	398820	259828	138992	53.49
873	88	Капиталбанк	2547	Ростовская обл.	397345	159459	237886	149.18
874	83	K2 Банк	2851	Дагестан	396588	180054	216534	120.26
875	27	Энтузиастбанк	3048	Москва и обл.	394120	317508	76612	24.13
876	43	ЭнергоБизнес	3485	Москва и обл.	393710	276298	117412	42.49
877	41	Азия Банк	3183	Москва и обл.	392820	276834	115986	41.9
878	11	Басманный	2158	Москва и обл.	383260	348979	34281	9.82
879	-45	Трансинвестбанк	3238	Москва и обл.	381125	518349	-137224	-26.47
880	-14	Максимум	466	Ростовская обл.	378018	431717	-53699	-12.44
881	-30	Рингкомбанк	1909	Ингушетия	377430	467039	-89609	-19.19
882	0	РИТЦ Банк	2677	Москва и обл.	370893	368810	2083	0.56
883	20	Еврорасчет	3498	Москва и обл.	359862	312832	47030	15.03
884	-13	Народный Инвестиционный Банк	2876	Самарская обл.	357423	412018	-54595	-13.25
885	35	АвтоКредитБанк	1973	Татарстан	355702	275272	80430	29.22
886	-2	КБЦ	914	Тверская обл.	352003	355342	-3339	-0.94
887	-43	Паритет	1860	Москва и обл.	349949	482299	-132350	-27.44
888	-90	Межбанковский Расчетный Центр	3325	Приморский край	348726	619917	-271191	-43.75
889	19	Кредо Финанс	793	Дагестан	340922	307137	33785	11
890	59	АББ	2937	Москва и обл.	339605	206046	133559	64.82
891	-13	Соверен Банк	3206	Татарстан	338586	390966	-52380	-13.4
892	1	АлтайБизнес-Банк	2388	Алтайский край	335504	333461	2043	0.61
893		Европейский Экспресс	3449	Москва и обл.	327903			
894	5	Логос	3233	Москва и обл.	322528	328341	-5813	-1.77
895	55	Невастройинвест	1926	Санкт-Петербург и обл.	315511	205280	110231	53.7
896	33	МВС Банк	2407	Дагестан	313849	253398	60451	23.86
897	79	Мигом	3323	Москва и обл.	313198	119662	193536	161.74
898	55	ТЭСТ	3440	Москва и обл.	312486	194540	117946	60.63
899	66	Каспий	639	Дагестан	311326	151230	160096	105.86
900	-43	Региональный Корпоративный Банк	1134	Ивановская обл.	301171	455297	-154126	-33.85
901	-20	Лидер	3304	Москва и обл.	299677	380150	-80473	-21.17
902	8	Дорис Банк	1679	Москва и обл.	293510	295858	-2348	-0.79
903	13	Терра	3476	Москва и обл.	289283	279718	9565	3.42
904	26	Континенталь	3184	Дагестан	288228	246566	41662	16.9
905	-22	Народный Банк Республики Тыва	1309	Тыва	284256	364374	-80118	-21.99
906	64	КредитАльянс	3472	Вологодская обл.	284061	135746	148315	109.26
907	53	Инстройбанк	2743	Москва и обл.	283669	163533	120136	73.46
908	39	1Банк	2896	Северная Осетия — Алания	276981	211982	64999	30.66
909	-44	Еврокапитал-Альянс	2672	Дагестан	275899	436317	-160418	-36.77
910	34	Рента-Банк	3095	Москва и обл.	275712	214040	61672	28.81
911	-5	Онлайн Банк	2462	Москва и обл.	273661	309150	-35489	-11.48
912	9	Кошелев-Банк	3300	Нижегородская обл.	273643	272162	1481	0.54
913	45	Городской Расчетный Центр	3346	Курганская обл.	272439	177669	94770	53.34
914	37	Фреско Банк	1415	Ярославская обл.	272072	197297	74775	37.9
915	2	Универсалтраст	3402	Москва и обл.	268307	279402	-11095	-3.97
916	32	Эно	1988	Дагестан	267467	206637	60830	29.44
917	38	ГРиС-Банк	1928	Ставропольский край	263899	188052	75847	40.33
918	-5	Альтернатива	3452	Москва и обл.	263813	284443	-20630	-7.25
919	27	Межрегиональный Банк Реконструкции	2620	Москва и обл.	257344	212854	44490	20.9
920	21	Континент Финанс	149	Калужская обл.	256290	220065	36225	16.46
921	14	ПрестижКредитБанк	2922	Дагестан	234903	235481	-578	-0.25
922	16	Воронеж	654	Воронежская обл.	234728	233677	1051	0.45
923	-95	Тайдон	2085	Кемеровская обл.	233642	539496	-305854	-56.69
924	-19	Таганрогбанк	3136	Ростовская обл.	233265	309216	-75951	-24.56
925	7	Интеррасчет	1618	Карачаево-Черкесия	232281	245040	-12759	-5.21
926	65	Межрегиональный центр микрокредитования	3489	Воронежская обл.	226529	24428	202101	827.33
927	46	Рунэтбанк	2829	Москва и обл.	221909	123249	98660	80.05
929	11	Центральная Расчетная Палата	3313	Москва и обл.	218465	225313	-6848	-3.04
930	12	Банковские Информационные Технологии	3318	Тульская обл.	214072	218759	-4687	-2.14
931	2	Лэнд-Банк	1478	Москва и обл.	213443	244209	-30766	-12.6
932	40	Первый Депозитный Банк	1244	Тверская обл.	211213	125131	86082	68.79
933	-11	Дербент-Кредит	2090	Дагестан	207036	268056	-61020	-22.76
934	34	Бизнесбанк	2862	Дагестан	203166	140094	63072	45.02
935	19	Алжан	2491	Дагестан	201423	193509	7914	4.09
936	-99	Петербургский Расчетный Центр	3306	Санкт-Петербург и обл.	196134	513623	-317489	-61.81
937	19	Столичная расчетная палата	3419	Вологодская обл.	186778	185470	1308	0.71
938	26	Зеленокумская	1239	Ставропольский край	159083	156724	2359	1.51
939	41	Евроинвест	3383	Москва и обл.	143637	79860	63777	79.86
940	27	ФФИН Банк (бывш. Охабанк)	1143	Сахалинская обл.	140737	140159	578	0.41
941	34	Расчетный Банковский Центр	3487	Москва и обл.	133315	120290	13025	10.83
942	3	Межбанковский Кредитный Союз	3242	Москва и обл.	119719	212925	-93206	-43.77
943	39	Русское Финансовое Общество	3427	Москва и обл.	117013	69188	47825	69.12
944		Фидбэк	3502	Воронежская обл.	116334			
945	32	Майма	1037	Республика Алтай	114339	115120	-781	-0.68
946	40	Транзит	2688	Дагестан	108644	54876	53768	97.98
947	36	Умут	2435	Дагестан	107886	66402	41484	62.47
948	26	Финансовые Услуги	3496	Москва и обл.	104608	122892	-18284	-14.88
949	35	Вест	2605	Москва и обл.	104417	55236	49181	89.04
950	9	Объединенная Расчетная Палата	3451	Москва и обл.	103766	175014	-71248	-40.71
951	11	Красноярский Краевой Расчетный Центр	3483	Красноярский край	99822	158322	-58500	-36.95
952	27	Сергиево-Посадская Расчетная Палата	384	Москва и обл.	90887	82126	8761	10.67
953	18	Платежный Клиринговый Дом	3343	Москва и обл.	83397	133164	-49767	-37.37
954	-2	Уральская Расчетная Палата	3326	Москва и обл.	72379	194757	-122378	-62.84
955	30	РИБ	2749	Москва и обл.	50406	54997	-4591	-8.35
956	31	Сулак	749	Дагестан	48543	48558	-15	-0.03
957	33	Первый Земельный Расчетный Центр	3381	Курская обл.	35641	25981	9660	37.18
958	31	Частный Расчетно-Кассовый Центр	3420	Москва и обл.	25639	26395	-756	-2.86
959	33	Тор Кредит	3497	Москва и обл.	23828	23487	341	1.45
960	33	Депозитный Кредитный Дом	3474	Москва и обл.	17959	17767	192	1.08
961	35	Сибирский Расчетный Центр	3308	Новосибирская обл.	17304	12187	5117	41.99
962	26	Инновационный Расчетный Центр	3447	Москва и обл.	16320	45162	-28842	-63.86
964	14	Национальная Расчетная Компания	3386	Москва и обл.	8388	83358	-74970	-89.94
965	32	Клиринговый Дом	3430	Санкт-Петербург и обл.	4061	3945	116	2.94
966	28	Межрегиональный Клиринговый Центр	3424	Москва и обл.	3979	17336	-13357	-77.05
967	32	Финансово-Расчетный Центр	3319	Нижегородская обл.	1810	1231	579	47.03
968	30	Международная Уральская Расчетная Палата	3322	Свердловская обл.	1773	2193	-420	-19.15
969	31	АРБ-Инкасс	3353	Москва и обл.	1157	1179	-22	-1.87
