Позиция в рейтинге	Изменение позиции в рейтинге	Название банка	Номер лицензии	Регион регистрации	Декабрь, 2014, тыс. рублей	Январь, 2014, тыс. рублей	Изменение, тыс. рублей	Изменение, %
1	0	Сбербанк России	1481	Москва и обл.	20451148750	16730027366	3721121384	22.24
2	0	ВТБ	1000	Санкт-Петербург и обл.	7718404263	5277158336	2441245927	46.26
3	0	Газпромбанк	354	Москва и обл.	4527651988	3622276552	905375436	24.99
4	0	ВТБ 24	1623	Москва и обл.	2767994716	2100686266	667308450	31.77
5	1	Банк Москвы	2748	Москва и обл.	2429501449	1828292759	601208690	32.88
6	1	Альфа-Банк	1326	Москва и обл.	2123947035	1562124365	561822670	35.97
7	-2	Россельхозбанк	3349	Москва и обл.	2114023345	1915951035	198072310	10.34
8	0	ФК Открытие	2209	Москва и обл.	1511339105	965044832	546294273	56.61
9	0	ЮниКредит Банк	1	Москва и обл.	1201919285	926606774	275312511	29.71
10	8	Национальный Клиринговый Центр	3466	Москва и обл.	1138395443	386777212	751618231	194.33
11	-1	Промсвязьбанк	3251	Москва и обл.	1004937750	752662475	252275275	33.52
12	0	Райффайзенбанк	3292	Москва и обл.	905911611	712061162	193850449	27.22
13	-2	Росбанк	2272	Москва и обл.	890749519	736292644	154456875	20.98
14	5	Ханты-Мансийский банк Открытие	1971	Москва и обл.	624586166	377588258	246997908	65.41
15	-2	Московский Кредитный Банк	1978	Москва и обл.	557249006	463414118	93834888	20.25
16	-1	Россия	328	Санкт-Петербург и обл.	527636913	418037106	109599807	26.22
17	-3	Банк «Санкт-Петербург»	436	Санкт-Петербург и обл.	514129079	447067129	67061950	15
18	-2	Русский Стандарт	2289	Москва и обл.	445677000	400349567	45327433	11.32
19	1	Ак Барс	2590	Татарстан	426179814	369547856	56631958	15.32
20	-3	Банк Уралсиб	2275	Москва и обл.	389972137	397439341	-7467204	-1.88
21	0	Ситибанк	2557	Москва и обл.	381893740	368811697	13082043	3.55
22	3	Нордеа Банк	3016	Москва и обл.	381172184	278160968	103011216	37.03
23	0	Связь-Банк	1470	Москва и обл.	377847175	352251341	25595834	7.27
24	0	МДМ Банк	323	Новосибирская обл.	375658797	334130788	41528009	12.43
25	-3	Хоум Кредит Банк	316	Москва и обл.	335340616	366989663	-31649047	-8.62
26	16	СМП Банк	3368	Москва и обл.	334200499	155807405	178393094	114.5
27	6	Бинбанк	2562	Москва и обл.	316826257	212410850	104415407	49.16
28	4	Национальный Банк «Траст»	3279	Москва и обл.	291254821	221942704	69312117	31.23
29	-2	Зенит	3255	Москва и обл.	288552228	258313361	30238867	11.71
30	-4	Глобэкс	1942	Москва и обл.	284828297	265305884	19522413	7.36
31	-1	ИНГ Банк	2495	Москва и обл.	274710153	235368484	39341669	16.71
32	54	Московский Областной Банк	1751	Москва и обл.	270138451	61691879	208446572	337.88
33	-4	Петрокоммерц	1776	Москва и обл.	262562141	249190047	13372094	5.37
34	-6	Восточный Экспресс Банк	1460	Амурская обл.	251010363	252605333	-1594970	-0.63
35	3	Новикомбанк	2546	Москва и обл.	231742817	173077891	58664926	33.9
36	-5	Возрождение	1439	Москва и обл.	231427104	223571868	7855236	3.51
37	16	Абсолют Банк	2306	Москва и обл.	223953193	118471689	105481504	89.04
38	-3	Уральский Банк Реконструкции и Развития	429	Свердловская обл.	220803549	207063585	13739964	6.64
39	1	Внешпромбанк	3261	Москва и обл.	211219791	163139873	48079918	29.47
40	-4	Московский Индустриальный Банк	912	Москва и обл.	207948017	201142624	6805393	3.38
41	-4	МТС Банк	2268	Москва и обл.	196458619	189190779	7267840	3.84
42	4	Совкомбанк	963	Костромская обл.	187623355	130913145	56710210	43.32
43	-4	ОТП Банк	2766	Москва и обл.	185469001	172558034	12910967	7.48
44	12	Российский Капитал	2312	Москва и обл.	173772954	115273070	58499884	50.75
45	-2	Транскапиталбанк (ТКБ)	2210	Москва и обл.	165649405	143726121	21923284	15.25
46	29	Российский Кредит	324	Москва и обл.	162266443	74993896	87272547	116.37
47	-6	Кредит Европа Банк	3311	Москва и обл.	161046273	161086412	-40139	-0.02
48	1	Татфондбанк	3058	Татарстан	157564198	127244422	30319776	23.83
49	-1	РосЕвроБанк	3137	Москва и обл.	148179928	129139704	19040224	14.74
50	4	Ренессанс Кредит	3354	Москва и обл.	135167771	118263004	16904767	14.29
51	18	Национальный Расчетный Депозитарий	3294	Москва и обл.	134814277	85680342	49133935	57.35
52	0	Азиатско-Тихоокеанский Банк	1810	Амурская обл.	134754435	120286448	14467987	12.03
53	4	Тинькофф Банк	2673	Москва и обл.	131125865	113486909	17638956	15.54
54	7	ДельтаКредит	3338	Москва и обл.	130602856	99318001	31284855	31.5
55	-8	МСП Банк	3340	Москва и обл.	129920841	130454519	-533678	-0.41
56	-12	Дойче Банк	3328	Москва и обл.	129344351	142772744	-13428393	-9.41
57	-6	Инвестторгбанк	2763	Москва и обл.	125757851	124645642	1112209	0.89
58	1	Пробизнесбанк	2412	Москва и обл.	124785622	105030954	19754668	18.81
59	-14	СКБ-Банк	705	Свердловская обл.	121228066	132220446	-10992380	-8.31
60	-2	Авангард	2879	Москва и обл.	120348909	109564368	10784541	9.84
61	-11	Росгосстрах Банк	3073	Москва и обл.	119823102	126937731	-7114629	-5.6
62	-7	Русфинанс Банк	1792	Самарская обл.	118461895	117279995	1181900	1.01
63	2	ЦентроКредит	121	Москва и обл.	115228184	91249235	23978949	26.28
64	-4	Пересвет	2110	Москва и обл.	113699652	103225230	10474422	10.15
65	-2	БНП Париба Банк	3407	Москва и обл.	113124212	97600228	15523984	15.91
66	8	Балтийский Банк	128	Москва и обл.	107683049	78000020	29683029	38.06
67	25	Югра	880	Ханты-Мансийский АО — Югра	107662909	55278093	52384816	94.77
68	-6	Запсибкомбанк	918	Тюменская обл.	104254848	97761659	6493189	6.64
69	15	Сетелем Банк	2168	Москва и обл.	101383612	62537247	38846365	62.12
70	-2	Всероссийский Банк Развития Регионов	3287	Москва и обл.	96312160	86824443	9487717	10.93
71	9	Металлинвестбанк	2440	Москва и обл.	91286427	68536319	22750108	33.19
72	-6	Банк БФА	3038	Санкт-Петербург и обл.	90915321	88460492	2454829	2.78
73	15	Эйч-Эс-Би-Си Банк (HSBC)	3290	Москва и обл.	90167566	58953818	31213748	52.95
74	9	Международный Финансовый Клуб	2618	Москва и обл.	87632138	64850799	22781339	35.13
75	-2	Центр-инвест	2225	Ростовская обл.	87377099	78033818	9343281	11.97
76	-6	Локо-Банк	2707	Москва и обл.	85330075	81647121	3682954	4.51
77	8	Сургутнефтегазбанк	588	Ханты-Мансийский АО — Югра	84211616	61717562	22494054	36.45
78	-11	Союз	2307	Москва и обл.	83897315	88368451	-4471136	-5.06
79	-3	Фондсервисбанк	2989	Москва и обл.	83384546	72927307	10457239	14.34
80	2	СБ Банк (Судостроительный банк)	2999	Москва и обл.	82332409	65831723	16500686	25.06
81	-17	Нота-Банк	2913	Москва и обл.	81431800	94702599	-13270799	-14.01
82	-3	Рост Банк	2888	Москва и обл.	80055343	69487949	10567394	15.21
83	-2	Балтинвестбанк	3176	Санкт-Петербург и обл.	76469758	66102193	10367565	15.68
84	-7	Банк Интеза	2216	Москва и обл.	73988269	70659500	3328769	4.71
85	2	Первобанк	3461	Самарская обл.	72902139	59159943	13742196	23.23
86	11	Интеркоммерц Банк	1657	Москва и обл.	71753157	49644457	22108700	44.53
87	4	Бинбанк кредитные карты	2827	Москва и обл.	70371722	55727921	14643801	26.28
88	-17	Связной Банк	1961	Москва и обл.	64842149	81517234	-16675085	-20.46
89	10	Креди Агриколь КИБ	1680	Санкт-Петербург и обл.	63591630	49084397	14507233	29.56
90	-12	Юниаструм Банк	2771	Москва и обл.	61709666	70012674	-8303008	-11.86
91	15	РосинтерБанк	226	Москва и обл.	59644389	43044973	16599416	38.56
92	2	Национальный Стандарт	3421	Москва и обл.	58970024	53366591	5603433	10.5
93	3	Тойота Банк	3470	Москва и обл.	58546009	52136213	6409796	12.29
94	6	Экспобанк	2998	Москва и обл.	55606589	48085710	7520879	15.64
95	44	Банк Финсервис	3388	Москва и обл.	55340038	30577498	24762540	80.98
96	38	Финпромбанк (ФПБ Банк)	2157	Москва и обл.	55246192	31286946	23959246	76.58
97	-4	Еврофинанс Моснарбанк	2402	Москва и обл.	54984743	54384932	599811	1.1
98	7	Меткомбанк (Череповец)	901	Вологодская обл.	54031976	43266319	10765657	24.88
99	36	Лето Банк	650	Москва и обл.	53708023	31141656	22566367	72.46
100	-5	Международный Банк Санкт-Петербурга (МБСП)	197	Санкт-Петербург и обл.	52650272	53351088	-700816	-1.31
101	-11	Кубань Кредит	2518	Краснодарский край	51733873	57080788	-5346915	-9.37
102	10	Фора-Банк	1885	Москва и обл.	51051381	38899721	12151660	31.24
103	18	БФГ-Кредит	3068	Москва и обл.	50480415	36616463	13863952	37.86
104	-6	Меткомбанк (Каменск-Уральский)	2443	Свердловская обл.	49709890	49211746	498144	1.01
105	-4	Таврический	2304	Санкт-Петербург и обл.	49440095	47660293	1779802	3.73
106	8	Аверс	415	Татарстан	49376981	38043727	11333254	29.79
107	42	Мосстройэкономбанк (М Банк)	948	Москва и обл.	49322086	27369001	21953085	80.21
108	1	Королевский Банк Шотландии	2594	Москва и обл.	48933138	41988811	6944327	16.54
109	53	АйСиБиСи Банк	3475	Москва и обл.	47478331	23966681	23511650	98.1
110	-21	Собинбанк	1317	Москва и обл.	47343915	58355817	-11011902	-18.87
111	34	Военно-Промышленный Банк	3065	Москва и обл.	47227976	28794109	18433867	64.02
112	-8	Экспресс-Волга	3085	Саратовская обл.	46121549	43566075	2555474	5.87
113	-5	Коммерцбанк (Евразия)	3333	Москва и обл.	45353084	42323804	3029280	7.16
114	-12	Межтопэнергобанк	2956	Москва и обл.	45225480	46937513	-1712033	-3.65
115	23	Фольксваген Банк Рус	3500	Москва и обл.	44724296	30871664	13852632	44.87
116	21	Банк «МБА-Москва»	3395	Москва и обл.	44504918	30918643	13586275	43.94
117	-4	СДМ-Банк	1637	Москва и обл.	42527005	38112600	4414405	11.58
118	6	Банк РСБ 24 (Русславбанк)	1073	Москва и обл.	41373501	35687851	5685650	15.93
119	9	Росэнергобанк	2211	Москва и обл.	40969858	33451735	7518123	22.47
120	9	Интерпромбанк	3266	Москва и обл.	40867717	33233088	7634629	22.97
121	-11	Примсоцбанк	2733	Приморский край	39522896	39706426	-183530	-0.46
122	-7	Крайинвестбанк	3360	Краснодарский край	39469306	37589424	1879882	5
123	-5	Челиндбанк	485	Челябинская обл.	38914403	36895817	2018586	5.47
124	-7	Кольцо Урала	65	Свердловская обл.	38376277	37273559	1102718	2.96
125	-3	Саровбизнесбанк	2048	Нижегородская обл.	38341319	36410267	1931052	5.3
126	-6	Русский Международный Банк	3123	Москва и обл.	38188551	36654256	1534295	4.19
127	-2	Интерпрогрессбанк	600	Москва и обл.	37869139	35314676	2554463	7.23
128	-5	Советский	558	Санкт-Петербург и обл.	37490502	36122767	1367735	3.79
129	3	Образование	1521	Москва и обл.	37281564	32375064	4906500	15.16
130	-14	Челябинвестбанк	493	Челябинская обл.	37175510	37563209	-387699	-1.03
131	55	Натиксис Банк	3390	Москва и обл.	36968869	20048872	16919997	84.39
132	12	ББР Банк	2929	Москва и обл.	36866305	29272931	7593374	25.94
133	-26	НС Банк	3124	Москва и обл.	36314322	42607300	-6292978	-14.77
134	26	М2М Прайвет Банк	1414	Москва и обл.	35866884	24245448	11621436	47.93
135	-8	Левобережный	1343	Новосибирская обл.	34423276	33640562	782714	2.33
136	0	Банк СГБ	2816	Вологодская обл.	34029605	31014929	3014676	9.72
137	11	Сумитомо Мицуи	3494	Москва и обл.	32836081	28317697	4518384	15.96
138	-19	БыстроБанк	1745	Удмуртия	32823787	36807600	-3983813	-10.82
139	-9	Газбанк	2316	Самарская обл.	32614401	32679412	-65011	-0.2
140	93	Бэнк оф Чайна	2309	Москва и обл.	32333259	13471520	18861739	140.01
141	5	Русстройбанк	3205	Москва и обл.	31799935	28491175	3308760	11.61
142	245	РН Банк	170	Москва и обл.	31419509	5483844	25935665	472.95
143	21	Транспортный	3174	Москва и обл.	31159153	23617700	7541453	31.93
144	11	Первый Чешско-Российский Банк	3291	Москва и обл.	30801215	25207455	5593760	22.19
145	2	АМБ Банк	3036	Москва и обл.	30310139	28457789	1852350	6.51
146	22	БКС — Инвестиционный Банк	101	Новосибирская обл.	30037913	22228832	7809081	35.13
147	-7	Банк АВБ	23	Самарская обл.	29787437	30222600	-435163	-1.44
148	-17	Агропромкредит	2880	Москва и обл.	28220885	32448394	-4227509	-13.03
149	-6	Дальневосточный Банк	843	Приморский край	28019669	29451731	-1432062	-4.86
150	11	Кредит Урал Банк	2584	Челябинская обл.	27958200	24130284	3827916	15.86
151	-10	Кедр	1574	Красноярский край	27076435	29907622	-2831187	-9.47
152	454	Российский Национальный Коммерческий Банк	1354	Москва и обл.	26885523	1930058	24955465	1292.99
153	16	Мерседес-Бенц Банк Рус	3473	Москва и обл.	26174995	21981503	4193492	19.08
154	21	Интехбанк	2705	Татарстан	26001233	21105485	4895748	23.2
155	-4	Региональный Кредит	1927	Костромская обл.	25903240	26782998	-879758	-3.28
156	-6	Липецккомбанк	1242	Липецкая обл.	25836898	27126231	-1289333	-4.75
157	-1	Приморье	3001	Приморский край	25589608	25177868	411740	1.64
158	12	Балтика	967	Москва и обл.	25560066	21946051	3614015	16.47
159	-6	Акибанк	2587	Татарстан	25237792	25893014	-655222	-2.53
160	-2	Девон-Кредит	1972	Татарстан	24933438	24945270	-11832	-0.05
161	-35	Банк Кредит Свисс	2494	Москва и обл.	24598725	33773415	-9174690	-27.17
162	4	Москоммерцбанк	3365	Москва и обл.	24494155	22500717	1993438	8.86
163	24	АктивКапитал Банк	3006	Самарская обл.	24306984	20020678	4286306	21.41
164	-10	Уральский Финансовый Дом	249	Пермская обл.	23821362	25770969	-1949607	-7.57
165	20	Легион	3117	Москва и обл.	23427049	20162700	3264349	16.19
166	-7	Альта-Банк	2269	Москва и обл.	23367735	24311157	-943422	-3.88
167	10	Спурт Банк	2207	Татарстан	22903035	20934923	1968112	9.4
168	11	Тимер Банк	1581	Татарстан	22867923	20748937	2118986	10.21
169	35	Тольяттихимбанк	2507	Самарская обл.	22696930	17214144	5482786	31.85
170	81	Данске Банк	3307	Санкт-Петербург и обл.	22290205	11904964	10385241	87.23
171	18	Ланта-Банк	1920	Москва и обл.	21753287	19912870	1840417	9.24
172	-15	Платежный Центр	3166	Новосибирская обл.	21636215	24955071	-3318856	-13.3
173	11	Морской Банк	77	Москва и обл.	21573795	20214905	1358890	6.72
174	4	Солидарность (Самара)	554	Самарская обл.	21247024	20785681	461343	2.22
175	53	ОФК Банк	2270	Москва и обл.	21240616	14037442	7203174	51.31
176	12	ФИА-Банк	2542	Самарская обл.	20972688	20000432	972256	4.86
177	4	АйМаниБанк	1975	Москва и обл.	20458740	20533051	-74311	-0.36
178	30	Газэнергобанк	3252	Калужская обл.	20409009	16256188	4152821	25.55
179	40	МАСТ-Банк	3267	Москва и обл.	20408977	15096998	5311979	35.19
180		Морган Стэнли Банк	3456	Москва и обл.	20368646			
181	-16	БМВ Банк	3482	Москва и обл.	20339806	23394432	-3054626	-13.06
182	11	Энергобанк	67	Татарстан	19939021	18497772	1441249	7.79
183	20	Транснациональный Банк	2108	Москва и обл.	19891090	17270630	2620460	15.17
184	-11	Алмазэргиэнбанк	2602	Саха (Якутия)	19880844	21294395	-1413551	-6.64
185	-3	Держава	2738	Москва и обл.	19733582	20319897	-586315	-2.89
186	19	Московское Ипотечное Агентство	3344	Москва и обл.	18984739	17129877	1854862	10.83
187	19	НБД-Банк	1966	Нижегородская обл.	18508173	17035473	1472700	8.64
188	38	Объединенный Капитал	2611	Санкт-Петербург и обл.	18263606	14207586	4056020	28.55
189	53	Денизбанк Москва	3330	Москва и обл.	18146065	12763699	5382366	42.17
190	10	Курскпромбанк	735	Курская обл.	18031721	17363945	667776	3.85
191	4	Норвик Банк	902	Кировская обл.	17465865	18188948	-723083	-3.98
192	10	Инвесткапиталбанк	2377	Башкортостан	17278229	17271388	6841	0.04
193	3	Уралтрансбанк	812	Свердловская обл.	17222514	18059366	-836852	-4.63
194	47	Анталбанк	3115	Москва и обл.	17076747	12891173	4185574	32.47
195	27	Расчетно-Кредитный Банк	103	Москва и обл.	16956326	14726248	2230078	15.14
196	-5	ГПБ-Ипотека	2403	Москва и обл.	16838350	19790666	-2952316	-14.92
197	4	Форштадт	2208	Оренбургская обл.	16817610	17304353	-486743	-2.81
198	19	Гранд Инвест Банк	3053	Москва и обл.	16703150	15158472	1544678	10.19
199	26	Нацинвестпромбанк	3077	Москва и обл.	16674336	14438455	2235881	15.49
200	21	Плюс Банк	1189	Москва и обл.	16596215	14763602	1832613	12.41
201	-9	Энерготрансбанк	1307	Калининградская обл.	16405158	18838271	-2433113	-12.92
202	63	СЭБ Банк	3235	Санкт-Петербург и обл.	16187580	10788300	5399280	50.05
203	-51	Национальный Резервный Банк	2170	Москва и обл.	16089351	26069436	-9980085	-38.28
204	20	Рублев	3098	Москва и обл.	16052168	14569410	1482758	10.18
205	-31	Алеф-Банк	2119	Москва и обл.	16044896	21165497	-5120601	-24.19
206	6	Банк Город	2644	Москва и обл.	16043002	15482085	560917	3.62
207	6	Хлынов	254	Кировская обл.	15690856	15473819	217037	1.4
208	46	Тусар	2712	Москва и обл.	15622859	11610799	4012060	34.55
209	49	Автоторгбанк	2776	Москва и обл.	15622073	11219850	4402223	39.24
210	19	Клиентский	2324	Москва и обл.	15384061	13871084	1512977	10.91
211	12	СтарБанк	548	Москва и обл.	15191377	14723627	467750	3.18
212	31	Росэксимбанк	2790	Москва и обл.	15182898	12483097	2699801	21.63
213	5	Национальная Факторинговая Компания	3437	Москва и обл.	15043044	15145851	-102807	-0.68
214	0	Росдорбанк	1573	Москва и обл.	14978058	15425491	-447433	-2.9
215	-82	Современный Коммерческий Банк (бывш. ДжиИ Мани Банк)	3316	Костромская обл.	14962321	31883907	-16921586	-53.07
216	95	Генбанк	2490	Москва и обл.	14926342	7906303	7020039	88.79
217	-18	Петербургский Социальный Коммерческий Банк	2551	Санкт-Петербург и обл.	14908129	17494915	-2586786	-14.79
218	-21	Развитие-Столица	3013	Москва и обл.	14678753	17660500	-2981747	-16.88
219	133	Чайна Констракшн	3515	Москва и обл.	14495202	6408000	8087202	126.2
220	-53	Аресбанк	2914	Москва и обл.	14235961	22291468	-8055507	-36.14
221	27	Росавтобанк	2767	Москва и обл.	14182075	12198485	1983590	16.26
222	98	Ишбанк	2867	Москва и обл.	14143456	7662544	6480912	84.58
223	-13	Гаранти Банк — Москва	3275	Москва и обл.	14088751	15934723	-1845972	-11.58
224	50	Стратегия	2801	Москва и обл.	14009394	10153582	3855812	37.97
225	2	БайкалБанк	2632	Бурятия	13958363	14182497	-224134	-1.58
226	9	Акцепт	567	Новосибирская обл.	13829368	13291190	538178	4.05
227	4	ТЭМБР-Банк	2764	Москва и обл.	13796320	13635263	161057	1.18
228	-34	Пойдем!	2534	Москва и обл.	13771046	18372966	-4601920	-25.05
229	10	НК Банк	2755	Москва и обл.	13503913	13036430	467483	3.59
230	20	Экономбанк	1319	Саратовская обл.	13378805	12088206	1290599	10.68
231	13	Русский Ипотечный Банк	1968	Москва и обл.	13198579	12481974	716605	5.74
232	64	Тройка-Д Банк	3431	Москва и обл.	13117370	8462054	4655316	55.01
233	33	Башкомснаббанк	1398	Башкортостан	13093448	10662479	2430969	22.8
234	-27	Первомайский	518	Краснодарский край	12862488	16991507	-4129019	-24.3
235	24	Гарант-Инвест	2576	Москва и обл.	12806858	11022288	1784570	16.19
236	-2	ВУЗ-Банк	1557	Свердловская обл.	12681531	13348626	-667095	-5
237	-1	Социнвестбанк	1132	Башкортостан	12593812	13199706	-605894	-4.59
238	0	Центркомбанк	2983	Москва и обл.	12590344	13059818	-469474	-3.59
239	21	Дил-Банк	3384	Москва и обл.	12182091	10979394	1202697	10.95
240	39	Русьуниверсалбанк	3293	Москва и обл.	12146033	9540050	2605983	27.32
241	22	Унифин	2654	Москва и обл.	12142075	10925717	1216358	11.13
242	25	Нефтяной Альянс	2859	Москва и обл.	12077141	10609306	1467835	13.84
243	2	Метробанк	2548	Москва и обл.	12057805	12330408	-272603	-2.21
244	-73	Гута-Банк	256	Москва и обл.	11800411	21687038	-9886627	-45.59
245	-36	Александровский	53	Санкт-Петербург и обл.	11731285	15977953	-4246668	-26.58
246	1	Солидарность (Москва)	1555	Москва и обл.	11730613	12226419	-495806	-4.06
247	33	ОПМ-Банк	2734	Москва и обл.	11703126	9521650	2181476	22.91
248	1	Киви Банк	2241	Москва и обл.	11672511	12150037	-477526	-3.93
249	8	Хованский	2145	Москва и обл.	11570322	11248314	322008	2.86
250	14	Солид Банк	1329	Камчатская обл.	11509121	10821564	687557	6.35
251	27	Международный Акционерный Банк	1987	Москва и обл.	11440034	9679195	1760839	18.19
252	33	Мир Бизнес Банк	3396	Москва и обл.	11283300	9089307	2193993	24.14
253	15	Прио-Внешторгбанк	212	Рязанская обл.	11272733	10559252	713481	6.76
254	17	Темпбанк	55	Москва и обл.	10927359	10306809	620550	6.02
255	20	ЕвроситиБанк	1869	Москва и обл.	10833327	9932141	901186	9.07
256	317	Кубаньторгбанк	478	Краснодарский край	10744231	2190546	8553685	390.48
257	-1	Оренбург	3269	Оренбургская обл.	10742972	11432505	-689533	-6.03
258	35	Кредит-Москва	5	Москва и обл.	10728036	8657658	2070378	23.91
259	10	Энергомашбанк	52	Санкт-Петербург и обл.	10610052	10512025	98027	0.93
260	22	Нико-Банк	702	Оренбургская обл.	10348501	9257244	1091257	11.79
261	43	Япы Креди Банк Москва	2555	Москва и обл.	10303692	8038649	2265043	28.18
262	135	Инбанк	1829	Москва и обл.	10234166	5296277	4937889	93.23
263	32	Европейский	1616	Калининградская обл.	10233007	8475681	1757326	20.73
264	33	Банк Расчетов и Сбережений	2617	Москва и обл.	10033240	8440143	1593097	18.88
265	12	Адмиралтейский	3054	Москва и обл.	9966433	9717518	248915	2.56
266	-13	Екатеринбург	3161	Свердловская обл.	9847415	11707107	-1859692	-15.89
267	93	Ури Банк	3479	Москва и обл.	9819854	6190145	3629709	58.64
268	-36	СИАБ	3245	Санкт-Петербург и обл.	9809874	13540623	-3730749	-27.55
269	21	Евромет	2902	Москва и обл.	9799694	8773681	1026013	11.69
270	6	Руснарбанк	3403	Москва и обл.	9761855	9737387	24468	0.25
271	17	КС Банк	1752	Мордовия	9755652	9001115	754537	8.38
272	50	Ставропольпромстройбанк	1288	Ставропольский край	9559200	7535271	2023929	26.86
273	21	Бенифит-Банк	3229	Москва и обл.	9402749	8486249	916500	10.8
274	279	Российская Финансовая Корпорация	3099	Москва и обл.	9335172	2376830	6958342	292.76
275	33	Инвестиционный Республиканский Банк	2571	Москва и обл.	9188201	7971571	1216630	15.26
276	16	Нефтепромбанк	2156	Москва и обл.	9143407	8702267	441140	5.07
277	-5	Банк Жилищного Финансирования	3138	Москва и обл.	9115527	10258244	-1142717	-11.14
278	-17	ЯР-Банк	3185	Москва и обл.	9057725	10975007	-1917282	-17.47
279	24	Нижневолжский Коммерческий Банк	931	Саратовская обл.	9053811	8089267	964544	11.92
280	174	Заречье	817	Татарстан	9045344	3796827	5248517	138.23
281	-41	Банк ПСА Финанс Рус	3481	Москва и обл.	8987256	12911469	-3924213	-30.39
282	4	Промсбербанк	1043	Москва и обл.	8927022	9073271	-146249	-1.61
283	22	Джей энд Ти Банк	3061	Москва и обл.	8925646	8006557	919089	11.48
284	3	Промтрансбанк	2638	Башкортостан	8873460	9012420	-138960	-1.54
285	43	Банк БКФ	2684	Москва и обл.	8837242	7215405	1621837	22.48
286	79	Азия-Инвест Банк	3303	Москва и обл.	8720140	6020464	2699676	44.84
287	52	Новопокровский	467	Краснодарский край	8680153	6945403	1734750	24.98
288	30	Развитие	2729	Карачаево-Черкесия	8617355	7703236	914119	11.87
289	9	Белгородсоцбанк	760	Белгородская обл.	8579540	8368107	211433	2.53
290	37	Московский Нефтехимический Банк	1411	Москва и обл.	8562098	7230812	1331286	18.41
291	24	Волга-Кредит	1153	Самарская обл.	8483492	7851313	632179	8.05
292	-8	Татсоцбанк	480	Татарстан	8377961	9142556	-764595	-8.36
293	7	Агросоюз	1459	Москва и обл.	8328330	8213788	114542	1.39
294	18	Рускобанк	138	Санкт-Петербург и обл.	8269602	7883023	386579	4.9
295	12	Славия	2664	Москва и обл.	8159285	7984761	174524	2.19
296	33	Альба Альянс	2593	Москва и обл.	8130033	7170110	959923	13.39
297	2	Экспресс-Кредит	210	Москва и обл.	8044450	8236075	-191625	-2.33
298	11	Финам Банк	2799	Москва и обл.	8036552	7949376	87176	1.1
299	-8	Роспромбанк	3204	Москва и обл.	7999656	8726313	-726657	-8.33
300	-19	Углеметбанк	2997	Челябинская обл.	7984880	9322430	-1337550	-14.35
301	1	ПИР Банк	2655	Москва и обл.	7982470	8101901	-119431	-1.47
302	-1	Снежинский	1376	Челябинская обл.	7974733	8174859	-200126	-2.45
303	38	Вокбанк	312	Нижегородская обл.	7929086	6835276	1093810	16
304	-93	РусЮгбанк	2093	Волгоградская обл.	7873940	15895336	-8021396	-50.46
305	-35	Миллениум Банк	3423	Москва и обл.	7840277	10323393	-2483116	-24.05
306	29	Русский Торговый Банк	2842	Москва и обл.	7830396	7053646	776750	11.01
307	24	Ассоциация	732	Нижегородская обл.	7810487	7138094	672393	9.42
308	11	Ижкомбанк	646	Удмуртия	7797768	7683092	114676	1.49
309	21	Голдман Сакс Банк	3490	Москва и обл.	7690141	7165924	524217	7.32
310	68	Нэклис-Банк	1671	Москва и обл.	7680397	5740771	1939626	33.79
311	25	Юг-Инвестбанк	2772	Краснодарский край	7574317	7025902	548415	7.81
312	13	ФДБ	3071	Москва и обл.	7568308	7339164	229144	3.12
313	24	Еврокоммерц	1777	Москва и обл.	7503479	6980276	523203	7.5
314	10	Томскпромстройбанк	1720	Томская обл.	7424923	7490011	-65088	-0.87
315	1	Северо-Восточный Альянс	2768	Москва и обл.	7422802	7840859	-418057	-5.33
316	10	Ренессанс	1939	Москва и обл.	7333758	7339047	-5289	-0.07
317	28	Бинбанк Мурманск	1276	Мурманская обл.	7297616	6726947	570669	8.48
318	29	Финансовый Стандарт	1053	Москва и обл.	7273044	6681791	591253	8.85
319	23	Таатта	1249	Саха (Якутия)	7268391	6827963	440428	6.45
320	75	Европлан Банк	3052	Москва и обл.	7219787	5330572	1889215	35.44
321	30	Анкор Банк	889	Татарстан	7124787	6487260	637527	9.83
322	51	Региональный Банк Развития	2782	Башкортостан	7109491	5862970	1246521	21.26
323	-34	Тихоокеанский Внешторгбанк	1378	Сахалинская обл.	6957520	8961795	-2004275	-22.36
324	-78	Объединенная Расчетная Система	3342	Москва и обл.	6925215	12251415	-5326200	-43.47
325	155	НБК-Банк	3283	Москва и обл.	6919905	3376932	3542973	104.92
326	24	Новый Московский Банк	2932	Москва и обл.	6900425	6642590	257835	3.88
327	17	Трансстройбанк	2807	Москва и обл.	6888108	6753524	134584	1.99
328	21	Инвестиционный Союз	637	Москва и обл.	6861033	6645454	215579	3.24
329	-12	Славянский Кредит	2960	Москва и обл.	6829815	7782929	-953114	-12.25
330	58	РЕСО Кредит	3450	Москва и обл.	6824862	5482216	1342646	24.49
331	12	Русь	704	Оренбургская обл.	6701152	6806822	-105670	-1.55
332	14	Кузнецкбизнесбанк	1158	Кемеровская обл.	6692772	6701901	-9129	-0.14
333	58	Эксперт Банк	2949	Омская обл.	6575302	5475772	1099530	20.08
334	-20	Вега-Банк	3270	Москва и обл.	6562533	7865860	-1303327	-16.57
335	18	Банк Казани	708	Татарстан	6553522	6355414	198108	3.12
336	-4	Муниципальный Камчатпрофитбанк	2103	Камчатская обл.	6509605	7124693	-615088	-8.63
337	21	Северный Кредит	2398	Вологодская обл.	6356413	6256725	99688	1.59
338	114	Милбанк	3256	Москва и обл.	6356017	3826901	2529116	66.09
339	28	Банк на Красных Воротах	2472	Москва и обл.	6326347	5957504	368843	6.19
340	28	Эл Банк	1025	Самарская обл.	6259155	5935821	323334	5.45
341	23	Актив Банк	2529	Мордовия	6185356	6028670	156686	2.6
342	-4	Банк Инноваций и Развития	2647	Москва и обл.	6090165	6975299	-885134	-12.69
343	64	Банкхаус Эрбе	1717	Москва и обл.	6084570	4989911	1094659	21.94
344	59	Объединенный Кредитный Банк	1118	Владимирская обл.	6068076	5069164	998912	19.71
345	45	Объединенный Банк Промышленных Инвестиций	2626	Москва и обл.	6043204	5480226	562978	10.27
346	86	Промрегионбанк	2123	Томская обл.	6023839	4458398	1565441	35.11
347	24	Век	2299	Москва и обл.	5995009	5871673	123336	2.1
348	46	Банк Торгового Финансирования	1982	Москва и обл.	5983432	5389531	593901	11.02
349	21	Северный Народный Банк	2721	Коми	5977538	5873305	104233	1.77
350	35	Эргобанк	2856	Москва и обл.	5949038	5526121	422917	7.65
351	11	Кранбанк	2271	Ивановская обл.	5939087	6079664	-140577	-2.31
352	-31	Уралкапиталбанк	2519	Башкортостан	5830758	7580367	-1749609	-23.08
353	83	Верхневолжский	1084	Ярославская обл.	5812799	4204234	1608565	38.26
354	75	Синко-Банк	2838	Москва и обл.	5769332	4506102	1263230	28.03
355	17	Донкомбанк	492	Ростовская обл.	5751677	5866666	-114989	-1.96
356	18	Невский Банк	1068	Санкт-Петербург и обл.	5748194	5826057	-77863	-1.34
357	4	Бинбанк Тверь	777	Тверская обл.	5737555	6111659	-374104	-6.12
358	-10	Банк БЦК-Москва	3480	Москва и обл.	5731879	6676843	-944964	-14.15
359	52	Тюменьагропромбанк	917	Тюменская обл.	5665961	4951704	714257	14.42
360	-5	Кузнецкий Мост	2254	Москва и обл.	5662343	6300780	-638437	-10.13
361	56	Современный Коммерческий Ипотечный Банк	3329	Москва и обл.	5639194	4836555	802639	16.6
362	-89	Международный Банк Развития	2704	Москва и обл.	5638221	10171471	-4533250	-44.57
363	88	МС Банк Рус	2789	Москва и обл.	5608902	3836763	1772139	46.19
364	25	Ю Би Эс Банк	3463	Москва и обл.	5604943	5480804	124139	2.26
365	15	Чувашкредитпромбанк	1280	Чувашия	5557193	5706108	-148915	-2.61
366	11	Камский Коммерческий Банк	438	Татарстан	5447656	5757203	-309547	-5.38
367	14	Национальный Залоговый Банк	2944	Москва и обл.	5445952	5648423	-202471	-3.58
368	118	Торговый Городской Банк	3180	Тверская обл.	5435963	3223967	2211996	68.61
369	36	Хакасский Муниципальный Банк	1049	Хакасия	5407573	5017413	390160	7.78
370	43	Финанс Бизнес Банк	520	Москва и обл.	5400858	4927508	473350	9.61
371	69	Консервативный Коммерческий Банк	1087	Астраханская обл.	5379121	4057468	1321653	32.57
372	-66	Платина	2347	Москва и обл.	5376330	7998740	-2622410	-32.79
373	3	Международный Коммерческий Банк	2524	Москва и обл.	5371685	5761523	-389838	-6.77
374	71	Московский Коммерческий Банк	3172	Москва и обл.	5321186	3972829	1348357	33.94
375	8	Стройлесбанк	2995	Тюменская обл.	5300778	5553187	-252409	-4.55
376	47	Банк Оранжевый	1659	Санкт-Петербург и обл.	5220815	4642652	578163	12.45
377	80	Сити Инвест Банк	3194	Санкт-Петербург и обл.	5218975	3689658	1529317	41.45
378	4	Проминвестбанк	2433	Москва и обл.	5177762	5566511	-388749	-6.98
379	111	Народный Доверительный Банк	2374	Москва и обл.	5130536	3162452	1968084	62.23
380	40	Риабанк	3434	Москва и обл.	5124471	4759650	364821	7.66
381	204	Межбанковский Кредитный Союз	3242	Москва и обл.	5109947	2083141	3026806	145.3
382	-28	Уральский Межрегиональный Банк	1441	Свердловская обл.	5067874	6301009	-1233135	-19.57
383	-8	Экономикс-Банк	2136	Москва и обл.	5030540	5782526	-751986	-13
384	46	Союзный	3236	Москва и обл.	5022397	4493091	529306	11.78
385	-16	Автоградбанк	1455	Татарстан	4990327	5911870	-921543	-15.59
386	0	Сибсоцбанк	2015	Алтайский край	4967390	5512868	-545478	-9.89
387	17	Банк Развития Технологий	3441	Москва и обл.	4962234	5033187	-70953	-1.41
388	-25	Зенит Сочи	232	Краснодарский край	4920122	6058887	-1138765	-18.79
389	57	Идея Банк	430	Краснодарский край	4906993	3969758	937235	23.61
390	32	Экси-Банк	2530	Санкт-Петербург и обл.	4854036	4702602	151434	3.22
391	81	Леноблбанк	1003	Санкт-Петербург и обл.	4852936	3489347	1363589	39.08
392	6	Москва-Сити	3247	Москва и обл.	4844490	5279637	-435147	-8.24
393	70	Новое Время	3492	Москва и обл.	4840952	3643875	1197077	32.85
394	7	Зернобанк	2337	Алтайский край	4826935	5195110	-368175	-7.09
395	33	Оргбанк	3312	Москва и обл.	4824935	4564156	260779	5.71
396	23	Межрегиональный промышленно-строительный банк	752	Мордовия	4783926	4782512	1414	0.03
397	3	ВостСибтранскомбанк	2731	Иркутская обл.	4782131	5205919	-423788	-8.14
398	-14	Промэнергобанк	2728	Вологодская обл.	4781403	5542675	-761272	-13.73
399	32	Газстройбанк	2919	Москва и обл.	4781270	4491160	290110	6.46
400	-21	Дагэнергобанк	3286	Дагестан	4773340	5713308	-939968	-16.45
401	7	Кремлевский	2905	Москва и обл.	4742379	4971670	-229291	-4.61
402	48	Еврокредит	2957	Москва и обл.	4735973	3884238	851735	21.93
403	-10	Межрегиональный Почтовый Банк	3171	Москва и обл.	4707364	5391690	-684326	-12.69
404	38	Конфидэнс Банк	970	Костромская обл.	4696801	4039684	657117	16.27
405	7	Межтрастбанк	2493	Москва и обл.	4694265	4942826	-248561	-5.03
406	52	Банк Раунд	2506	Москва и обл.	4555421	3683183	872238	23.68
407	-8	Мосуралбанк	2468	Москва и обл.	4516437	5264918	-748481	-14.22
408	1	Русский Трастовый Банк	1139	Москва и обл.	4436185	4965428	-529243	-10.66
409	-13	Банк ИТБ	3128	Москва и обл.	4419656	5320270	-900614	-16.93
410	60	Сибирский Банк Реконструкции и Развития	1284	Тюменская обл.	4417568	3562280	855288	24.01
411	325	Региональный Банк Сбережений	3367	Москва и обл.	4415837	911360	3504477	384.53
412	9	Енисейский Объединенный Банк	2645	Красноярский край	4407808	4704161	-296353	-6.3
413	79	Владпромбанк	870	Владимирская обл.	4402124	3151613	1250511	39.68
414	30	Итуруп	2390	Сахалинская обл.	4372315	3994599	377716	9.46
415	54	Коммерческий Индо Банк	3446	Москва и обл.	4367586	3584326	783260	21.85
416	65	Мираф-Банк	2244	Омская обл.	4342994	3345526	997468	29.81
417	26	Новобанк	1352	Новгородская обл.	4280162	4036344	243818	6.04
418	92	Гагаринский	606	Москва и обл.	4259756	2833334	1426422	50.34
419	75	Рапида	3371	Москва и обл.	4140551	3075590	1064961	34.63
420	-80	Руссобанк	2313	Москва и обл.	4132330	6841936	-2709606	-39.6
421	14	Лесбанк	1598	Москва и обл.	4129882	4315301	-185419	-4.3
422	16	Бинбанк Смоленск	1957	Смоленская обл.	4101314	4130416	-29102	-0.7
423	-110	МАК-Банк	1088	Москва и обл.	4093884	7878988	-3785104	-48.04
424	23	Земский Банк	2900	Самарская обл.	4079621	3942331	137290	3.48
425	63	Профессионал Банк	2471	Москва и обл.	4068118	3176915	891203	28.05
426	7	Кузнецкий	609	Пензенская обл.	3995280	4425172	-429892	-9.71
427	40	Витабанк	356	Санкт-Петербург и обл.	3952223	3608434	343789	9.53
428	9	Интернациональный Торговый Банк	2609	Омская обл.	3936965	4197833	-260868	-6.21
429	5	Ермак	1809	Ханты-Мансийский АО — Югра	3884564	4419899	-535335	-12.11
430	-3	Веста	2368	Москва и обл.	3881116	4593569	-712453	-15.51
431	89	Кошелев-Банк	3300	Самарская обл.	3875923	2635711	1240212	47.05
432	-30	Горбанк	2982	Санкт-Петербург и обл.	3871915	5078387	-1206472	-23.76
433	8	Роял Кредит Банк	783	Хабаровский край	3841749	4046668	-204919	-5.06
434	-10	Банк Экономический Союз	2798	Москва и обл.	3810308	4631030	-820722	-17.72
435	-19	БайкалИнвестБанк	1067	Иркутская обл.	3803637	4894825	-1091188	-22.29
436	23	Финансово-Промышленный Капитал	3295	Москва и обл.	3730378	3675747	54631	1.49
437	28	Промсельхозбанк	538	Москва и обл.	3685371	3628351	57020	1.57
438	1	Мастер-Капитал	3011	Москва и обл.	3665723	4079662	-413939	-10.15
439	-13	Нейва	1293	Свердловская обл.	3638301	4598240	-959939	-20.88
440	37	Уссури	596	Хабаровский край	3628064	3407950	220114	6.46
441	75	Воронеж	654	Воронежская обл.	3585275	2758420	826855	29.98
442	-17	Профит Банк	3234	Москва и обл.	3558488	4627635	-1069147	-23.1
443	35	Форус Банк	3457	Нижегородская обл.	3539367	3406197	133170	3.91
444	91	МФБанк	3163	Москва и обл.	3518882	2494973	1023909	41.04
445	42	Венец	524	Ульяновская обл.	3504553	3182748	321805	10.11
446	-40	Церих	3278	Орловская обл.	3499405	4992027	-1492622	-29.9
447	-55	Сибнефтебанк	385	Тюменская обл.	3471980	5445919	-1973939	-36.25
448	58	Гринфилдбанк	2711	Москва и обл.	3411614	2854529	557085	19.52
449	11	Камчаткомагропромбанк	545	Камчатская обл.	3381932	3667083	-285151	-7.78
450	14	Наш Дом	3296	Москва и обл.	3379069	3632655	-253586	-6.98
451	58	Витязь	2890	Москва и обл.	3369432	2834764	534668	18.86
452	66	Крокус-Банк	2682	Москва и обл.	3363631	2706132	657499	24.3
453	108	Бест Эффортс Банк	435	Москва и обл.	3358600	2322903	1035697	44.59
454	7	Алтайкапиталбанк	2659	Алтайский край	3341482	3658947	-317465	-8.68
455	90	Ринвестбанк	3262	Рязанская обл.	3307247	2427479	879768	36.24
456	44	Нокссбанк	3202	Волгоградская обл.	3289177	2956831	332346	11.24
457	32	РТС-Банк	3401	Самарская обл.	3286212	3176637	109575	3.45
458	45	Северо-Западный 1 Альянс Банк	766	Санкт-Петербург и обл.	3282982	2921629	361353	12.37
459	46	Вологжанин	1896	Вологодская обл.	3278687	2902978	375709	12.94
460	-11	Долинск	857	Сахалинская обл.	3272240	3889077	-616837	-15.86
461	13	Тамбовкредитпромбанк	1312	Тамбовская обл.	3272126	3424069	-151943	-4.44
462	57	Айви Банк	2055	Москва и обл.	3271846	2677350	594496	22.2
463	13	Океан Банк	1697	Москва и обл.	3270644	3415240	-144596	-4.23
464	134	Мурманский Расчетный Центр	3341	Мурманская обл.	3260697	1994981	1265716	63.45
465	52	Инвестсоцбанк	3010	Москва и обл.	3247442	2756051	491391	17.83
466	7	Живаго-Банк	2065	Рязанская обл.	3239829	3476240	-236411	-6.8
467	232	Первый Клиентский Банк	3436	Москва и обл.	3239411	1159167	2080244	179.46
468	30	Уралпромбанк	2964	Челябинская обл.	3237667	2986413	251254	8.41
469	-3	Элита	1399	Калужская обл.	3203965	3622895	-418930	-11.56
470	80	Столичный Кредит	2853	Москва и обл.	3157928	2401114	756814	31.52
471	-3	Аксонбанк	680	Костромская обл.	3151521	3592468	-440947	-12.27
472	13	Интерактивный Банк	3378	Москва и обл.	3149031	3289140	-140109	-4.26
473	-11	РБА	3413	Москва и обл.	3138752	3654630	-515878	-14.12
474	28	Зираат Банк	2559	Москва и обл.	3097565	2937616	159949	5.44
475	73	Юнистрим	3467	Москва и обл.	3090051	2404299	685752	28.52
476	23	Росбизнесбанк	1405	Москва и обл.	3083259	2971475	111784	3.76
477	69	Русский Национальный Банк	469	Ростовская обл.	3082779	2420299	662480	27.37
478	6	Преодоление	2649	Москва и обл.	3060415	3290990	-230575	-7.01
479	47	Таурус Банк	655	Москва и обл.	3030052	2594303	435749	16.8
480	17	Агророс	2860	Саратовская обл.	3019398	2986569	32829	1.1
481	-26	Ваш Личный Банк	1222	Иркутская обл.	2993595	3763922	-770327	-20.47
482	-64	Крыловский	456	Краснодарский край	2945754	4819039	-1873285	-38.87
483	55	Газтрансбанк	665	Адыгея	2933232	2480904	452328	18.23
484	-28	Евроальянс	1781	Ивановская обл.	2920942	3736236	-815294	-21.82
485	69	Выборг-Банк	720	Санкт-Петербург и обл.	2879334	2367446	511888	21.62
486	50	Богородский Муниципальный Банк	2992	Москва и обл.	2856034	2493255	362779	14.55
487	96	Евразийский Банк	969	Москва и обл.	2847949	2084902	763047	36.6
488	84	Заубер Банк	1614	Санкт-Петербург и обл.	2832622	2200656	631966	28.72
489	-10	Финансовый Капитал	3288	Санкт-Петербург и обл.	2801633	3393181	-591548	-17.43
490	69	Донхлеббанк	2285	Ростовская обл.	2796427	2325872	470555	20.23
491	80	Национальный Корпоративный Банк	3422	Москва и обл.	2795723	2209398	586325	26.54
492	50	Кубанский Универсальный Банк	2898	Краснодарский край	2791800	2452729	339071	13.82
493	-45	Интеркредит	3047	Москва и обл.	2788243	3927671	-1139428	-29.01
494	81	Единый Строительный Банк	3506	Омская обл.	2764532	2176615	587917	27.01
495	1	Костромаселькомбанк	1115	Костромская обл.	2759512	3060568	-301056	-9.84
496	66	ФорБанк	2063	Алтайский край	2736753	2322380	414373	17.84
497	105	Сибэс	208	Омская обл.	2680355	1977093	703262	35.57
498	150	Алтынбанк	2070	Татарстан	2675340	1492542	1182798	79.25
499	5	Мегаполис	3265	Чувашия	2674180	2905939	-231759	-7.98
500	-7	Енисей	474	Красноярский край	2651477	3114872	-463395	-14.88
501	218	Прайм Финанс	2758	Санкт-Петербург и обл.	2650340	1044438	1605902	153.76
502	9	Апабанк	2404	Москва и обл.	2636210	2828510	-192300	-6.8
503	48	РСКБ	2050	Москва и обл.	2633236	2390437	242799	10.16
504	-90	Торгово-Строительный Банк	1250	Москва и обл.	2612273	4909707	-2297434	-46.79
505	53	Объединенный Резервный Банк	937	Москва и обл.	2604683	2336200	268483	11.49
506	17	Братский АНКБ	1144	Иркутская обл.	2596687	2622271	-25584	-0.98
507	62	Аспект	608	Москва и обл.	2591427	2246199	345228	15.37
508	74	Тульский Промышленник	2382	Тульская обл.	2591331	2093495	497836	23.78
509	59	Кросна-Банк	2607	Москва и обл.	2552939	2265885	287054	12.67
510	20	Индустриальный Сберегательный Банк	3175	Москва и обл.	2545846	2544999	847	0.03
511	146	Народный Банк	2249	Карачаево-Черкесия	2531736	1445344	1086392	75.16
512	297	Арксбанк	1868	Москва и обл.	2504083	559339	1944744	347.69
513	-154	Кроссинвестбанк	2849	Москва и обл.	2503293	6198702	-3695409	-59.62
514	63	Вестерн Юнион ДП Восток	2726	Москва и обл.	2492772	2135613	357159	16.72
515	81	Стелла-Банк	2948	Ростовская обл.	2481853	2037262	444591	21.82
516	17	Богородский	1277	Нижегородская обл.	2481746	2513458	-31712	-1.26
517	-22	ЕвроАксис Банк	3273	Москва и обл.	2479710	3073850	-594140	-19.33
518	87	Газнефтьбанк	3223	Саратовская обл.	2471669	1937705	533964	27.56
519	3	Иваново	1763	Ивановская обл.	2459928	2623529	-163601	-6.24
520		Н-Банк	3493	Москва и обл.	2443623			
521	-14	Капитал	575	Москва и обл.	2440752	2842771	-402019	-14.14
522	52	Банкирский Дом	2928	Санкт-Петербург и обл.	2413404	2180505	232899	10.68
523	4	Радиотехбанк	1166	Нижегородская обл.	2393290	2578003	-184713	-7.16
524	-71	Бинбанк Сургут	1701	Ханты-Мансийский АО — Югра	2378569	3803309	-1424740	-37.46
525	19	Резерв	2364	Челябинская обл.	2365066	2444150	-79084	-3.24
526	-55	Лайтбанк	3177	Москва и обл.	2353665	3508844	-1155179	-32.92
527	10	Яринтербанк	2564	Ярославская обл.	2351182	2481723	-130541	-5.26
528	69	Кредит Экспресс	3186	Ростовская обл.	2346665	2033358	313307	15.41
529	61	Татагропромбанк	728	Татарстан	2335692	2069262	266430	12.88
530	-29	Коммерческий Банк Развития	3364	Москва и обл.	2328179	2944572	-616393	-20.93
531	-2	Йошкар-Ола	2802	Марий Эл	2319345	2565297	-245952	-9.59
532	-1	Вкабанк	1027	Астраханская обл.	2318135	2535612	-217477	-8.58
533	271	Центрально-Европейский Банк	2670	Москва и обл.	2315173	594437	1720736	289.47
534	5	ИРС	272	Москва и обл.	2309937	2470130	-160193	-6.49
535	-14	Проинвестбанк	784	Пермская обл.	2238170	2633902	-395732	-15.02
536	13	Констанс-Банк	2228	Санкт-Петербург и обл.	2237936	2403710	-165774	-6.9
537	4	Национальный Банк Сбережений	1949	Ивановская обл.	2228351	2459166	-230815	-9.39
538	49	Владбизнесбанк	903	Владимирская обл.	2220195	2081446	138749	6.67
539	37	Спиритбанк	2053	Тульская обл.	2215911	2162518	53393	2.47
540	72	Приско Капитал Банк	2537	Москва и обл.	2205928	1862070	343858	18.47
541	60	Викинг	2	Санкт-Петербург и обл.	2193275	1981837	211438	10.67
542	28	Риал-Кредит	3393	Москва и обл.	2191128	2214107	-22979	-1.04
543	13	Крона-Банк	2499	Иркутская обл.	2178114	2354089	-175975	-7.48
544	-20	Система	2846	Москва и обл.	2160010	2621172	-461162	-17.59
545	22	Бум-Банк	1137	Кабардино-Балкария	2154010	2271209	-117199	-5.16
546	6	Россита-Банк	3257	Москва и обл.	2151036	2380391	-229355	-9.64
547	-34	Первый Инвестиционный банк	604	Москва и обл.	2143423	2801744	-658321	-23.5
548	75	Санкт-Петербургский Банк Инвестиций	3468	Санкт-Петербург и обл.	2131563	1719847	411716	23.94
549	14	Пермь	875	Пермская обл.	2113997	2313300	-199303	-8.62
550	-35	Унифондбанк	3416	Москва и обл.	2107479	2762509	-655030	-23.71
551	62	Яндекс.Деньги	3510	Россия	2103845	1856100	247745	13.35
552	14	Новация	840	Адыгея	2090659	2272926	-182267	-8.02
553	57	Московско-Парижский Банк	2646	Москва и обл.	2079176	1897444	181732	9.58
554	55	БСТ-Банк	2883	Кемеровская обл.	2069236	1920856	148380	7.72
555	-12	Финтрастбанк	3104	Москва и обл.	2040663	2450165	-409502	-16.71
556	52	Канский	860	Красноярский край	2023869	1926846	97023	5.04
557	98	Региональный Коммерческий Банк	836	Ульяновская обл.	2015485	1470126	545359	37.1
558	84	Акцент	696	Оренбургская обл.	1977122	1561513	415609	26.62
559	95	Международный Строительный Банк	3484	Москва и обл.	1963269	1472559	490710	33.32
560	18	ИК Банк	1732	Татарстан	1930506	2128177	-197671	-9.29
561	71	Глобус	2438	Москва и обл.	1916974	1656588	260386	15.72
562	66	Бумеранг	1002	Вологодская обл.	1909802	1699406	210396	12.38
563	37	Нальчик	695	Кабардино-Балкария	1909001	1982235	-73234	-3.69
564	16	КОР	2148	Волгоградская обл.	1897442	2107546	-210104	-9.97
565	-5	Новый Символ	370	Москва и обл.	1885169	2323239	-438070	-18.86
566	-83	Смартбанк	3408	Москва и обл.	1876627	3304981	-1428354	-43.22
567	50	Старооскольский Агропромбанк	1050	Белгородская обл.	1873622	1797958	75664	4.21
568	224	K2 Банк	2851	Карачаево-Черкесия	1867880	647252	1220628	188.59
569		Икано Банк	3519	Центр	1864916			
570	69	РФИ Банк	3351	Москва и обл.	1856374	1618437	237937	14.7
571	113	Еврокапитал-Альянс	3459	Ярославская обл.	1849856	1252881	596975	47.65
572	19	Холмск	503	Сахалинская обл.	1839441	2068434	-228993	-11.07
573	102	Метрополь	1639	Москва и обл.	1838141	1294302	543839	42.02
574	61	Земкомбанк	574	Ростовская обл.	1832151	1636292	195859	11.97
575	45	Социум-Банк	2881	Москва и обл.	1818629	1783485	35144	1.97
576	55	Максима	3379	Москва и обл.	1770513	1678009	92504	5.51
577	18	Московский Вексельный Банк	2697	Москва и обл.	1747568	2039557	-291989	-14.32
578	11	Екатерининский	2167	Москва и обл.	1739779	2070347	-330568	-15.97
579	91	Капиталбанк	2547	Ростовская обл.	1734517	1316073	418444	31.79
580	45	Златкомбанк	568	Москва и обл.	1708512	1716267	-7755	-0.45
581	11	Современные Стандарты Бизнеса	3397	Москва и обл.	1704463	2062438	-357975	-17.36
582	4	Дом-Банк	3209	Москва и обл.	1701018	2082338	-381320	-18.31
583	21	Тагилбанк	1635	Свердловская обл.	1701017	1959999	-258982	-13.21
584	77	Уралфинанс	1370	Свердловская обл.	1673764	1424120	249644	17.53
585	8	Сталь Банк	2248	Москва и обл.	1672082	2056366	-384284	-18.69
586	25	Америкэн Экспресс Банк	3460	Москва и обл.	1663334	1895918	-232584	-12.27
587	1	Торжокуниверсалбанк	933	Тверская обл.	1659512	2071629	-412117	-19.89
588	-80	Инкаробанк	2696	Москва и обл.	1646741	2837089	-1190348	-41.96
589	74	Плато-Банк	2071	Свердловская обл.	1636345	1414860	221485	15.65
590	171	Алданзолотобанк	854	Саха (Якутия)	1633263	803082	830181	103.37
591	-34	Пульс Столицы	3002	Москва и обл.	1632605	2344528	-711923	-30.37
592	103	Севзапинвестпромбанк	2152	Санкт-Петербург и обл.	1625052	1178293	446759	37.92
593	111	Банк Премьер Кредит	1663	Москва и обл.	1609730	1138498	471232	41.39
594	85	Промышленно-Финансовое Сотрудничество	2410	Москва и обл.	1606698	1274842	331856	26.03
595	23	Вэлтон Банк	1105	Белгородская обл.	1598427	1795394	-196967	-10.97
596	87	Агроинкомбанк	1946	Астраханская обл.	1597129	1268668	328461	25.89
597	37	Михайловский ПЖСБ	2961	Волгоградская обл.	1591189	1642816	-51627	-3.14
598	123	Аделантбанк	1835	Москва и обл.	1577441	1020531	556910	54.57
599	-44	ИпоТек Банк	2794	Москва и обл.	1576624	2361470	-784846	-33.24
600	51	Мосводоканалбанк	2863	Москва и обл.	1576342	1483198	93144	6.28
601	100	Ганзакомбанк	1734	Санкт-Петербург и обл.	1573104	1150345	422759	36.75
602	5	Интеркапитал-Банк	2706	Мордовия	1566849	1927560	-360711	-18.71
603	35	Соколовский	2830	Москва и обл.	1564547	1628234	-63687	-3.91
604	49	Саратов	330	Саратовская обл.	1540114	1478159	61955	4.19
605	171	Джаст Банк	3503	Москва и обл.	1539932	727700	812232	111.62
606	96	Объединенный Банк Республики	1016	Чувашия	1536652	1146996	389656	33.97
607	17	Новый Кредитный Союз	3139	Москва и обл.	1533852	1717513	-183661	-10.69
608	39	Гринкомбанк	1184	Иркутская обл.	1532641	1492731	39910	2.67
609	10	Геленджик-Банк	790	Краснодарский край	1530890	1791480	-260590	-14.55
610	156	Банк ВВБ	1093	Ярославская обл.	1526817	768185	758632	98.76
611	11	Банк МБФИ	2073	Москва и обл.	1526488	1759256	-232768	-13.23
612	-84	Траст Капитал Банк	2741	Москва и обл.	1521259	2575202	-1053943	-40.93
613	2	Приобье	537	Ханты-Мансийский АО — Югра	1516860	1837160	-320300	-17.43
614	15	Жилкредит	1736	Москва и обл.	1503587	1688987	-185400	-10.98
615	11	Майкопбанк	1136	Адыгея	1492698	1706685	-213987	-12.54
616	0	Далена	1948	Москва и обл.	1491966	1801108	-309142	-17.16
617	60	Арзамас	1281	Нижегородская обл.	1491654	1286469	205185	15.95
618	38	Бизнес для Бизнеса	1060	Чувашия	1463762	1446964	16798	1.16
619	-5	Ростфинанс	481	Ростовская обл.	1460706	1845470	-384764	-20.85
620	17	Строительно-Коммерческий Банк	3050	Санкт-Петербург и обл.	1454851	1632145	-177294	-10.86
621	22	Калуга	1151	Калужская обл.	1453101	1558231	-105130	-6.75
622	70	Синергия	2884	Саратовская обл.	1444691	1195537	249154	20.84
623	50	Спутник	1071	Оренбургская обл.	1442512	1304113	138399	10.61
624	-59	Кредитинвест	1197	Дагестан	1437087	2282978	-845891	-37.05
625	5	Примтеркомбанк	21	Приморский край	1435075	1688255	-253180	-15
626	42	Великие Луки Банк	598	Псковская обл.	1434748	1355954	78794	5.81
627	6	Кетовский Коммерческий Банк	842	Курганская обл.	1416991	1643888	-226897	-13.8
628	-1	Почтобанк	1788	Пермская обл.	1405174	1703322	-298148	-17.5
629	-30	Национальный Банк Взаимного Кредита	3214	Москва и обл.	1405056	1983824	-578768	-29.17
630	104	Металлург	2877	Москва и обл.	1392966	924694	468272	50.64
631	49	Вологдабанк	992	Вологодская обл.	1387508	1269814	117694	9.27
632	55	Саммит Банк	85	Приморский край	1379751	1247159	132592	10.63
633	121	ЮМК	3495	Краснодарский край	1378816	820864	557952	67.97
634	40	Тайм Банк	3120	Москва и обл.	1375231	1301172	74059	5.69
635	6	Межрегиональный Клиринговый Банк	2543	Москва и обл.	1370364	1568392	-198028	-12.63
636	-15	Руна-Банк	3207	Москва и обл.	1361625	1774239	-412614	-23.26
637	-53	Кредпромбанк	1165	Ярославская обл.	1353880	2083906	-730026	-35.03
638	22	Академический Русский Банк	622	Москва и обл.	1336583	1436500	-99917	-6.96
639	212	Объединенный Национальный Банк	2074	Нижегородская обл.	1325914	349317	976597	279.57
640	4	Кемсоцинбанк	96	Кемеровская обл.	1312041	1557919	-245878	-15.78
641	24	Азимут	3154	Москва и обл.	1307504	1372110	-64606	-4.71
642	30	Содружество	2923	Москва и обл.	1300372	1306223	-5851	-0.45
643	96	Фреско Банк	1415	Москва и обл.	1298242	904421	393821	43.54
644	-97	Мострансбанк	2258	Москва и обл.	1296037	2419586	-1123549	-46.44
645	17	Булгар Банк	1917	Татарстан	1282801	1423723	-140922	-9.9
646	40	Смолевич	1121	Смоленская обл.	1268805	1247515	21290	1.71
647	136	Межрегионбанк	1059	Москва и обл.	1262676	685678	576998	84.15
648	61	Химик	1114	Нижегородская обл.	1262026	1109170	152856	13.78
649	68	Сельмашбанк	106	Ростовская обл.	1260334	1054513	205821	19.52
650	-56	Единственный	3187	Москва и обл.	1251007	2055830	-804823	-39.15
651		Оней Банк	3516	Москва и обл.	1243632			
652	-2	Нерюнгрибанк	825	Саха (Якутия)	1242742	1486468	-243726	-16.4
653	38	Первый Дортрансбанк	3271	Кировская обл.	1238599	1199364	39235	3.27
654	68	Взаимодействие	1704	Новосибирская обл.	1233914	1018814	215100	21.11
655	57	Миръ	3089	Москва и обл.	1222222	1084482	137740	12.7
656	68	1Банк	2896	Северная Осетия — Алания	1200995	998963	202032	20.22
657	53	Ноосфера	2650	Республика Алтай	1181675	1103917	77758	7.04
658	-13	Акрополь	3027	Москва и обл.	1181281	1554137	-372856	-23.99
659	-134	Эльбин	2267	Дагестан	1174681	2617728	-1443047	-55.13
660	47	Финарс Банк	2938	Москва и обл.	1162031	1116561	45470	4.07
661	28	Новый Промышленный Банк	930	Москва и обл.	1133952	1216217	-82265	-6.76
662	54	НоваховКапиталБанк	635	Москва и обл.	1130722	1063587	67135	6.31
663	-17	Республиканский Кредитный Альянс	3017	Москва и обл.	1126965	1518453	-391488	-25.78
664	51	Евроазиатский Инвестиционный Банк	2897	Москва и обл.	1124678	1067410	57268	5.37
665	28	Дон-Тексбанк	1818	Ростовская обл.	1116347	1184945	-68598	-5.79
666	-14	Сервис-Резерв	2034	Москва и обл.	1106055	1478309	-372254	-25.18
667	112	РУБанк	2813	Москва и обл.	1087507	712139	375368	52.71
668	55	ЕАТП Банк	1765	Астраханская обл.	1080466	1013595	66871	6.6
669	-5	Онего	2484	Карелия	1071389	1375727	-304338	-22.12
670	38	Регионфинансбанк	3357	Москва и обл.	1061099	1111042	-49943	-4.5
671	55	Камский Горизонт	2554	Татарстан	1052499	988891	63608	6.43
672	53	Мурманский Социальный Коммерческий Банк	2722	Мурманская обл.	1039482	998956	40526	4.06
673	122	Тальменка-Банк	826	Алтайский край	1026473	639135	387338	60.6
674	59	Турбобанк	3203	Санкт-Петербург и обл.	1013947	925611	88336	9.54
675	57	Байкалкредобанк	2990	Иркутская обл.	1007784	938463	69321	7.39
676	14	Расчетный Дом	3350	Москва и обл.	1005760	1204742	-198982	-16.52
677	-37	Уралприватбанк	153	Свердловская обл.	1004366	1614055	-609689	-37.77
678	-146	Банк РМП	2574	Москва и обл.	1000098	2518692	-1518594	-60.29
679	41	Тетраполис	1586	Санкт-Петербург и обл.	996734	1024161	-27427	-2.68
680	14	Тандем	1951	Москва и обл.	994578	1182630	-188052	-15.9
681	129	Соверен Банк	3206	Москва и обл.	988379	557639	430740	77.24
682	36	Новый Век	3417	Москва и обл.	980700	1047522	-66822	-6.38
683	45	Жилстройбанк	2769	Москва и обл.	967646	971625	-3979	-0.41
684	150	Южный Региональный Банк	3015	Ростовская обл.	955087	443582	511505	115.31
685	11	Курган	2568	Курганская обл.	950664	1174239	-223575	-19.04
686	88	Вятич	2796	Рязанская обл.	948529	729753	218776	29.98
687	16	Московский Клиринговый Центр	3314	Москва и обл.	941005	1142158	-201153	-17.61
688	43	Спецстройбанк	236	Москва и обл.	937255	943098	-5843	-0.62
689	-8	Си Ди Би Банк	3339	Краснодарский край	932587	1269749	-337162	-26.55
690	7	Интеркоопбанк	2803	Москва и обл.	925331	1171556	-246225	-21.02
691	-112	Тендер-Банк	2252	Москва и обл.	924660	2116686	-1192026	-56.32
692	63	Ипозембанк	3026	Самарская обл.	907605	820431	87174	10.63
693	53	Акция	927	Ивановская обл.	901679	861618	40061	4.65
694	64	СМБ-Банк	3504	Санкт-Петербург и обл.	893439	807432	86007	10.65
695	76	Прокоммерцбанк	2996	Москва и обл.	889326	754408	134918	17.88
696	73	НСТ-Банк	1738	Оренбургская обл.	879704	760121	119583	15.73
697	-61	Русский Элитарный Банк	3231	Москва и обл.	868483	1634016	-765533	-46.85
698	32	Вакобанк	1291	Псковская обл.	868103	944298	-76195	-8.07
699	-28	Тексбанк	2756	Карачаево-Черкесия	867674	1308343	-440669	-33.68
700	47	Космос	2245	Москва и обл.	862638	856873	5765	0.67
701	-16	Флора-Москва	533	Москва и обл.	850611	1250876	-400265	-32
702	40	Инвест-Экобанк	1956	Санкт-Петербург и обл.	844460	893187	-48727	-5.46
703	57	Русский Банк Сбережений	779	Ставропольский край	839315	805483	33832	4.2
704	47	Динамичные Системы	3439	Москва и обл.	830588	834370	-3782	-0.45
705	24	МТИ-Банк	1052	Москва и обл.	829294	968276	-138982	-14.35
706	44	Московский Национальный Инвестиционный Банк	3181	Москва и обл.	825595	843346	-17751	-2.1
707	92	Стандарт-Кредит	841	Адыгея	819743	625959	193784	30.96
708	60	Ресурс-Траст	3122	Москва и обл.	815692	763675	52017	6.81
709	36	Классик Эконом Банк	3298	Северная Осетия — Алания	815027	875633	-60606	-6.92
710	-170	ПК-Банк	2652	Нижегородская обл.	812722	2469134	-1656412	-67.08
711	48	Прохладный	874	Кабардино-Балкария	810059	807230	2829	0.35
712	28	Центрально-Азиатский	3037	Хакасия	809154	904249	-95095	-10.52
713	39	Москва	1661	Москва и обл.	806659	823681	-17022	-2.07
714	48	Невастройинвест	1926	Санкт-Петербург и обл.	791689	779408	12281	1.58
715	72	Майский	1673	Кабардино-Балкария	785349	672899	112450	16.71
716	123	ГРиС-Банк	1928	Ставропольский край	765232	423731	341501	80.59
717	-6	Мико-Банк	3195	Москва и обл.	756825	1086106	-329281	-30.32
718	46	Славянбанк	804	Новгородская обл.	755916	772547	-16631	-2.15
719		ПэйПал РУ	3517	Москва и обл.	753741			
720	50	Русский Финансовый Альянс	2035	Москва и обл.	747186	755964	-8778	-1.16
721	36	Анелик РУ	3443	Москва и обл.	744174	808612	-64438	-7.97
722	79	Внешфинбанк	3173	Краснодарский край	740434	623294	117140	18.79
723	15	Международный Расчетный Банк	3028	Москва и обл.	738762	906209	-167447	-18.48
724	70	Народный Инвестиционный Банк	2876	Самарская обл.	737740	640318	97422	15.21
725	28	Лидер	3304	Москва и обл.	723401	821424	-98023	-11.93
726	46	Первоуральскбанк	965	Свердловская обл.	721278	748618	-27340	-3.65
727	21	Кузбассхимбанк	2868	Кемеровская обл.	702089	855203	-153114	-17.9
728	56	Региональный Корпоративный Банк	1134	Москва и обл.	688914	684395	4519	0.66
729	36	Арсенал	3000	Москва и обл.	683451	771099	-87648	-11.37
730	110	Далта-Банк	142	Приморский край	679172	423252	255920	60.47
731	54	Банк РСИ	3415	Москва и обл.	656344	682535	-26191	-3.84
732	11	Бузулукбанк	1282	Оренбургская обл.	650322	888691	-238369	-26.82
733	42	Балаково-Банк	444	Саратовская обл.	649316	729436	-80120	-10.98
734	66	Гефест	1046	Тверская обл.	638829	624182	14647	2.35
735	47	РусьРегионБанк	685	Москва и обл.	635688	688420	-52732	-7.66
736	84	ВРБ Москва	3499	Москва и обл.	624752	515815	108937	21.12
737	77	Энтузиастбанк	3048	Москва и обл.	622696	543661	79035	14.54
738	91	АББ	2937	Москва и обл.	621712	482834	138878	28.76
739	57	Холдинвестбанк	2837	Москва и обл.	613227	639046	-25819	-4.04
740	63	Народный Земельно-Промышленный Банк	2873	Алтайский край	607952	601426	6526	1.09
741	76	АлтайБизнес-Банк	2388	Алтайский край	599985	530608	69377	13.08
742	64	АвтоКредитБанк	1973	Татарстан	590933	574832	16101	2.8
743	-65	Вестинтербанк	3398	Москва и обл.	571759	1280936	-709177	-55.36
744	122	ТЭСТ	3440	Москва и обл.	562430	259656	302774	116.61
745	73	Межрегиональный Банк Реконструкции	2620	Москва и обл.	551533	527832	23701	4.49
746	34	Геобанк	2027	Москва и обл.	551463	695939	-144476	-20.76
747	-144	Нарат	1902	Саратовская обл.	540419	1960806	-1420387	-72.44
748	65	Стар Альянс	3433	Москва и обл.	529707	549557	-19850	-3.61
749	59	Старый Кремль	2657	Москва и обл.	528436	560519	-32083	-5.72
750	36	Континенталь	3184	Ставропольский край	522399	675601	-153202	-22.68
751	94	Максимум	466	Ростовская обл.	514390	407016	107374	26.38
752	79	Дружба	990	Тюменская обл.	513582	478847	34735	7.25
753	37	ОЛМА-Банк	3250	Москва и обл.	511834	653537	-141703	-21.68
754	34	Башпромбанк	1006	Башкортостан	505324	657014	-151690	-23.09
755	66	Рента-Банк	3095	Москва и обл.	502448	515479	-13031	-2.53
756	49	Берейт	3505	Санкт-Петербург и обл.	488736	579596	-90860	-15.68
757	50	Новокиб	1747	Кемеровская обл.	479531	565807	-86276	-15.25
758	70	Логос	3233	Москва и обл.	478307	484778	-6471	-1.33
759	66	Иронбанк	1724	Москва и обл.	462821	505545	-42724	-8.45
760	59	МВС Банк	2407	Дагестан	456899	517206	-60307	-11.66
761	-34	Азия Банк	3183	Москва и обл.	456593	976187	-519594	-53.23
762	40	Эко-Инвест	3116	Москва и обл.	450204	615033	-164829	-26.8
763	74	Петербургский Расчетный Центр	3306	Санкт-Петербург и обл.	445829	429987	15842	3.68
764	84	РИТЦ Банк	2677	Москва и обл.	442442	396766	45676	11.51
765	33	Восточно-Европейский Трастовый Банк	2253	Москва и обл.	442056	630500	-188444	-29.89
766	93	Бринкс	3486	Москва и обл.	435110	292824	142286	48.59
767	85	Альтернатива	3452	Москва и обл.	413968	345903	68065	19.68
768	13	Промсвязьинвест	2761	Дагестан	411617	693948	-282331	-40.68
769	72	Алжан	2491	Дагестан	409755	422140	-12385	-2.93
770	-64	Приполярком	507	Тюменская обл.	408836	1125621	-716785	-63.68
771	59	НКБ	2942	Калмыкия	404480	481064	-76584	-15.92
772	75	Далетбанк	3049	Москва и обл.	404122	397430	6692	1.68
773	49	Европейский Стандарт	3200	Кабардино-Балкария	394665	513259	-118594	-23.11
774	50	Информпрогресс	2166	Москва и обл.	392561	509231	-116670	-22.91
775	-211	Банк Сберегательно-кредитного сервиса	3224	Москва и обл.	379726	2293851	-1914125	-83.45
776	13	Тульский Расчетный Центр	3380	Тульская обл.	378828	656298	-277470	-42.28
777	1	Адам Интернэшнл	2232	Дагестан	376103	721089	-344986	-47.84
778	34	Лада-Кредит	2668	Москва и обл.	368953	552854	-183901	-33.26
779	47	Кредо Финанс	793	Дагестан	367819	493769	-125950	-25.51
780	63	Таганрогбанк	3136	Ростовская обл.	356145	409092	-52947	-12.94
781	51	Народный Банк Республики Тыва	1309	Тыва	348543	475607	-127064	-26.72
782	72	Сетевая Расчетная Палата	3332	Татарстан	348129	329964	18165	5.51
783	63	Еврокапитал-Альянс	2672	Дагестан	346828	400997	-54169	-13.51
784	72	Лэнд-Банк	1478	Москва и обл.	342013	316690	25323	8
785	72	Терра	3476	Москва и обл.	332738	310988	21750	6.99
786	75	ФФИН Банк (бывш. Охабанк)	1143	Сахалинская обл.	329322	288244	41078	14.25
787	68	Дорис Банк	1679	Москва и обл.	324010	323144	866	0.27
788	84	Северстройбанк	3507	Вологодская обл.	318160	201064	117096	58.24
789	74	Регнум	3373	Москва и обл.	306379	283411	22968	8.1
790	75	Конгресс-Банк	2330	Москва и обл.	302591	262997	39594	15.05
791		Электронный платежный сервис	3509	Москва и обл.	293892			
792	83	Русское Финансовое Общество	3427	Москва и обл.	281509	168366	113143	67.2
793	57	Расчетная Палата СВМБ	3324	Самарская обл.	278760	372507	-93747	-25.17
794	29	Идеалбанк	3491	Москва и обл.	265242	511078	-245836	-48.1
796		Дельта Кей	3513	Москва и обл.	259050			
797	63	Континент Финанс	149	Калужская обл.	258662	290119	-31457	-10.84
798	69	Тайдон	2085	Кемеровская обл.	240835	238413	2422	1.02
799	71	Майма	1037	Республика Алтай	238977	207678	31299	15.07
800	36	Эно	1988	Краснодарский край	236595	432330	-195735	-45.27
801	67	Рунэтбанк	2829	Москва и обл.	232844	227806	5038	2.21
802	-35	Сургутский Центральный Коммерческий Банк	684	Ханты-Мансийский АО — Югра	228683	767629	-538946	-70.21
803	79	РИБ	2749	Москва и обл.	194628	130231	64397	49.45
804	65	Красноярский Краевой Расчетный Центр	3483	Красноярский край	184976	226986	-42010	-18.51
805	73	Монета.ру	3508	Марий Эл	144453	145948	-1495	-1.02
806	78	Фидбэк	3502	Москва и обл.	141957	117824	24133	20.48
807	64	Деньги.Мэйл.Ру	3511	Москва и обл.	130356	203787	-73431	-36.03
808	73	Банковские Информационные Технологии	3318	Тульская обл.	127324	130988	-3664	-2.8
809	70	Платежный Клиринговый Дом	3343	Москва и обл.	127259	145344	-18085	-12.44
810	75	Зеленокумская	1239	Ставропольский край	123475	117717	5758	4.89
811	72	КредитАльянс	3472	Вологодская обл.	118903	126588	-7685	-6.07
812	65	Умут	2435	Дагестан	102552	152493	-49941	-32.75
813	73	Вест	2605	Москва и обл.	87538	77281	10257	13.27
814	62	Евроинвест	3383	Москва и обл.	85743	164998	-79255	-48.03
815		Универсальная электронная карта	3524	Москва и обл.	80762			
816	74	Сергиево-Посадская Расчетная Палата	384	Москва и обл.	77472	58090	19382	33.37
817		Единая касса	3512	Москва и обл.	67275			
818	80	Частный Расчетно-Кассовый Центр	3420	Москва и обл.	63133	24381	38752	158.94
819	69	Первый Земельный Расчетный Центр	3381	Курская обл.	34190	71518	-37328	-52.19
820	72	Инновационный Расчетный Центр	3447	Москва и обл.	26973	56227	-29254	-52.03
821	76	Тор Кредит	3497	Москва и обл.	25429	24400	1029	4.22
822	65	Интеррасчет	1618	Москва и обл.	23744	76687	-52943	-69.04
823	71	Транзит	2688	Дагестан	22306	36160	-13854	-38.31
824		Премиум	3514	Москва и обл.	20339			
825		НКО «МОБИ.Деньги»	3523	Москва и обл.	11785			
826		21 Век	3309	Санкт-Петербург и обл.	9658			
827	74	Клиринговый Дом	3430	Санкт-Петербург и обл.	4242	4251	-9	-0.21
828	71	Финансово-Расчетный Центр	3319	Астраханская обл.	2927	15063	-12136	-80.57
829	73	АРБ-Инкасс	3353	Москва и обл.	2592	2767	-175	-6.32
