Позиция в рейтинге	Изменение позиции в рейтинге	Название банка	Номер лицензии	Регион регистрации	Декабрь, 2013, тыс. рублей	Январь, 2013, тыс. рублей	Изменение, тыс. рублей	Изменение, %
1	0	Сбербанк России	1481	Москва и обл.	15895724834	14082252862	1813471972	12.88
2	0	ВТБ	1000	Санкт-Петербург и обл.	5263350401	4338506970	924843431	21.32
3	0	Газпромбанк	354	Москва и обл.	3511406147	2814389584	697016563	24.77
4	2	ВТБ 24	1623	Москва и обл.	2088711302	1511500758	577210544	38.19
5	0	Банк Москвы	2748	Москва и обл.	1893576791	1520101934	373474857	24.57
6	-2	Россельхозбанк	3349	Москва и обл.	1842414211	1672771138	169643073	10.14
7	0	Альфа-Банк	1326	Москва и обл.	1495597624	1377045587	118552037	8.61
8	0	ЮниКредит Банк	1	Москва и обл.	860744791	886111726	-25366935	-2.86
9	2	ФК Открытие	2209	Москва и обл.	850938971	658177268	192761703	29.29
10	2	Райффайзенбанк	3292	Москва и обл.	763444846	636129628	127315218	20.01
11	-2	Промсвязьбанк	3251	Москва и обл.	759378124	703512015	55866109	7.94
12	-2	Росбанк	2272	Москва и обл.	751134817	694965066	56169751	8.08
13	7	Московский Кредитный Банк	1978	Москва и обл.	440946405	320218464	120727941	37.7
14	1	Банк «Санкт-Петербург»	436	Санкт-Петербург и обл.	436362147	377459109	58903038	15.61
15	6	Россия	328	Санкт-Петербург и обл.	421906520	320073599	101832921	31.82
16	-2	Банк Уралсиб	2275	Москва и обл.	414634443	452552670	-37918227	-8.38
17	5	Русский Стандарт	2289	Москва и обл.	386607580	301700094	84907486	28.14
18	0	Хоум Кредит Банк	316	Москва и обл.	381853684	331652350	50201334	15.14
19	-2	Ак Барс	2590	Татарстан	371308190	342762257	28545933	8.33
20	-1	Ситибанк	2557	Москва и обл.	349583620	326162434	23421186	7.18
21	11	Национальный Клиринговый Центр	3466	Москва и обл.	345248811	211699749	133549062	63.08
22	1	Ханты-Мансийский банк Открытие	1971	Тюменская обл.	344800254	298476987	46323267	15.52
23	-7	МДМ Банк	323	Новосибирская обл.	342001188	369245138	-27243950	-7.38
24	0	Связь-Банк	1470	Москва и обл.	304080913	269560402	34520511	12.81
25	0	Нордеа Банк	3016	Москва и обл.	291867956	265476257	26391699	9.94
26	4	ИНГ Банк	2495	Москва и обл.	274005455	221820082	52185373	23.53
27	-1	Глобэкс	1942	Москва и обл.	272105815	236339119	35766696	15.13
28	1	Зенит	3255	Москва и обл.	258665942	226905452	31760490	14
29	-2	Восточный Экспресс Банк	1460	Амурская обл.	255217435	233182612	22034823	9.45
30	-2	Петрокоммерц	1776	Москва и обл.	247764433	233056908	14707525	6.31
31	2	Банк «Открытие»	2179	Москва и обл.	227440559	192344693	35095866	18.25
32	-1	Возрождение	1439	Москва и обл.	223094393	221393243	1701150	0.77
33	1	Национальный Банк «Траст»	3279	Москва и обл.	219506244	183375283	36130961	19.7
34	4	Бинбанк	2562	Москва и обл.	213477065	164032856	49444209	30.14
35	2	МТС Банк	2268	Москва и обл.	202892162	168131059	34761103	20.68
36	5	Уральский Банк Реконструкции и Развития	429	Свердловская обл.	202768395	147422942	55345453	37.54
37	-2	Московский Индустриальный Банк	912	Москва и обл.	200242375	172675164	27567211	15.96
38	1	ОТП Банк	2766	Москва и обл.	180248691	158934553	21314138	13.41
39	7	Внешпромбанк	3261	Москва и обл.	162020851	117442614	44578237	37.96
40	3	Новикомбанк	2546	Москва и обл.	157851636	130481520	27370116	20.98
41	-1	СМП Банк	3368	Москва и обл.	156813809	147603845	9209964	6.24
42	3	Кредит Европа Банк	3311	Москва и обл.	154542370	120512039	34030331	28.24
43	-7	Дойче Банк	3328	Москва и обл.	151522043	170515233	-18993190	-11.14
44	0	Транскапиталбанк (ТКБ)	2210	Москва и обл.	145677703	122646212	23031491	18.78
45	-3	СКБ-Банк	705	Свердловская обл.	136666498	135371008	1295490	0.96
46	2	МСП Банк	3340	Москва и обл.	134547367	115891829	18655538	16.1
47	12	Совкомбанк	963	Костромская обл.	129351909	97772413	31579496	32.3
48	4	Авангард	2879	Москва и обл.	124962784	110130208	14832576	13.47
49	4	Татфондбанк	3058	Татарстан	124697095	108152554	16544541	15.3
50	11	Азиатско-Тихоокеанский Банк	1810	Амурская обл.	123263686	91033983	32229703	35.4
51	-4	РосЕвроБанк	3137	Москва и обл.	122322536	116715944	5606592	4.8
52	-2	Инвестторгбанк	2763	Москва и обл.	122153102	111382988	10770114	9.67
53	21	Тинькофф Банк	2673	Москва и обл.	117062219	75414961	41647258	55.22
54	2	Росгосстрах Банк	3073	Москва и обл.	116835525	103668352	13167173	12.7
55	10	Ренессанс Кредит	3354	Москва и обл.	115853186	89492688	26360498	29.46
56	-1	Русфинанс Банк	1792	Самарская обл.	114377714	107935177	6442537	5.97
57	-3	Пробизнесбанк	2412	Москва и обл.	113040541	107984819	5055722	4.68
58	-7	Абсолют Банк	2306	Москва и обл.	111654466	110483276	1171190	1.06
59	-1	Российский Капитал	2312	Москва и обл.	109922459	100318559	9603900	9.57
60	11	ДельтаКредит	3338	Москва и обл.	99403998	80169491	19234507	23.99
61	7	Пересвет	2110	Москва и обл.	98488075	84625399	13862676	16.38
62	2	БНП Париба Банк	3407	Москва и обл.	93579340	89537170	4042170	4.51
63	16	ЦентроКредит	121	Москва и обл.	92985422	72157363	20828059	28.86
64	6	Банк Интеза	2216	Москва и обл.	89728174	81724535	8003639	9.79
65	1	Запсибкомбанк	918	Тюменская обл.	89264530	87519776	1744754	1.99
66	-17	Национальный Расчетный Депозитарий	3294	Москва и обл.	88011420	112653228	-24641808	-21.87
67	9	Всероссийский Банк Развития Регионов	3287	Москва и обл.	87585123	74287442	13297681	17.9
68	4	Союз	2307	Москва и обл.	87099539	79129303	7970236	10.07
69	17	Банк БФА	3038	Санкт-Петербург и обл.	85254966	56183522	29071444	51.74
70	5	Нота-Банк	2913	Москва и обл.	84897943	75380556	9517387	12.63
71	-11	КИТ Финанс Инвестиционный Банк	1911	Санкт-Петербург и обл.	84462618	92900420	-8437802	-9.08
72	-3	Связной Банк	1961	Москва и обл.	81297978	82285015	-987037	-1.2
73	5	Локо-Банк	2707	Москва и обл.	80739693	72555717	8183976	11.28
74	7	Центр-инвест	2225	Ростовская обл.	79230032	64581199	14648833	22.68
75	-12	Юниаструм Банк	2771	Москва и обл.	73572314	90427375	-16855061	-18.64
76	4	Фондсервисбанк	2989	Москва и обл.	72902567	68343355	4559212	6.67
77	-10	Балтийский Банк	128	Москва и обл.	71760640	84821302	-13060662	-15.4
78	35	Российский Кредит	324	Москва и обл.	71008443	33708405	37300038	110.66
79	102	Рост Банк	2888	Москва и обл.	67634930	18296499	49338431	269.66
80	7	СБ Банк (Судостроительный банк)	2999	Москва и обл.	67552308	54949476	12602832	22.94
81	3	Инвестбанк	107	Москва и обл.	67445302	57517684	9927618	17.26
82	16	Московский Областной Банк	1751	Москва и обл.	66419021	44006519	22412502	50.93
83	0	Балтинвестбанк	3176	Санкт-Петербург и обл.	65643657	62468221	3175436	5.08
84	-7	Собинбанк	1317	Москва и обл.	63928525	72611320	-8682795	-11.96
85	9	Сургутнефтегазбанк	588	Тюменская обл.	63538881	50524562	13014319	25.76
86	-4	Металлинвестбанк	2440	Москва и обл.	63154265	63412208	-257943	-0.41
87	1	Международный Финансовый Клуб	2618	Москва и обл.	60861248	53092901	7768347	14.63
88	-3	Первобанк	3461	Самарская обл.	60100830	57180933	2919897	5.11
89	-32	Эйч-Эс-Би-Си Банк (HSBC)	3290	Москва и обл.	59920166	101728610	-41808444	-41.1
90	182	Югра	880	Тюменская обл.	58677580	9692523	48985057	505.39
91	43	Сетелем Банк	2168	Москва и обл.	58331652	27408447	30923205	112.82
92	0	Бинбанк кредитные карты	2827	Москва и обл.	57781515	51038703	6742812	13.21
93	-4	Международный Банк Санкт-Петербурга (МБСП)	197	Санкт-Петербург и обл.	54308629	52056401	2252228	4.33
94	-4	Национальный Стандарт	3421	Москва и обл.	53351701	51687335	1664366	3.22
95	8	Тойота Банк	3470	Москва и обл.	52542836	40789634	11753202	28.81
96	6	Кубань Кредит	2518	Краснодарский край	51660440	42981620	8678820	20.19
97	-2	Интеркоммерц Банк	1657	Москва и обл.	51294791	47517935	3776856	7.95
98	2	Таврический	2304	Санкт-Петербург и обл.	49648441	43472351	6176090	14.21
99	2	Королевский Банк Шотландии	2594	Москва и обл.	48622754	43083878	5538876	12.86
100	9	Коммерцбанк (Евразия)	3333	Москва и обл.	47664660	34706431	12958229	37.34
101	4	Межтопэнергобанк	2956	Москва и обл.	45490576	37670059	7820517	20.76
102	-3	Экспресс-Волга	3085	Саратовская обл.	45405190	43477455	1927735	4.43
103	-12	Креди Агриколь КИБ	1680	Санкт-Петербург и обл.	44580413	51263618	-6683205	-13.04
104	24	Экспобанк	2998	Москва и обл.	44330974	30541437	13789537	45.15
105	-12	Меткомбанк (Каменск-Уральский)	2443	Свердловская обл.	43875662	51015742	-7140080	-14
106	-2	Народный Кредит	2401	Москва и обл.	41753282	40566440	1186842	2.93
107	0	Примсоцбанк	2733	Приморский край	40555421	35803131	4752290	13.27
108	-46	Еврофинанс Моснарбанк	2402	Москва и обл.	40106224	90491009	-50384785	-55.68
109	43	РосинтерБанк	226	Москва и обл.	39997277	23122638	16874639	72.98
110	-13	НС Банк	3124	Москва и обл.	38995005	45287894	-6292889	-13.9
111	13	Первый Республиканский Банк	1730	Москва и обл.	38464071	30835634	7628437	24.74
112	7	Крайинвестбанк	3360	Краснодарский край	37979189	32590132	5389057	16.54
113	-5	Челябинвестбанк	493	Челябинская обл.	37951942	34975801	2976141	8.51
114	-4	Челиндбанк	485	Челябинская обл.	37497941	33959957	3537984	10.42
115	-1	Меткомбанк (Череповец)	901	Вологодская обл.	37403093	33650306	3752787	11.15
116	-1	Фора-Банк	1885	Москва и обл.	37305002	33533818	3771184	11.25
117	37	Аверс	415	Татарстан	36664861	22928941	13735920	59.91
118	0	Русский Международный Банк	3123	Москва и обл.	36659033	32835242	3823791	11.65
119	-2	СДМ-Банк	1637	Москва и обл.	36433522	33150606	3282916	9.9
120	-24	Банк Кредит Свисс	2494	Москва и обл.	36374406	45396565	-9022159	-19.87
121	1	Левобережный	1343	Новосибирская обл.	35797058	31718714	4078344	12.86
122	-11	Кольцо Урала	65	Свердловская обл.	35323538	33944479	1379059	4.06
123	17	БФГ-Кредит	3068	Москва и обл.	35207758	25207031	10000727	39.67
124	-8	Саровбизнесбанк	2048	Нижегородская обл.	35177850	33232110	1945740	5.85
125	26	Советский	558	Санкт-Петербург и обл.	34780199	23220496	11559703	49.78
126	-5	Смоленский Банк	2029	Смоленская обл.	34677813	32140623	2537190	7.89
127	4	Интерпромбанк	3266	Москва и обл.	34248976	29253543	4995433	17.08
128	30	Банк РСБ 24 (Русславбанк)	1073	Москва и обл.	33049132	22424456	10624676	47.38
129	18	Интерпрогрессбанк	600	Москва и обл.	32230302	24453765	7776537	31.8
130	-4	Современный Коммерческий Банк (бывш. ДжиИ Мани Банк)	3316	Москва и обл.	32067892	30654097	1413795	4.61
131	13	Образование	1521	Москва и обл.	31792856	24879661	6913195	27.79
132	-2	Газбанк	2316	Самарская обл.	31747540	29641660	2105880	7.1
133	6	БыстроБанк	1745	Удмуртия	31647511	25662433	5985078	23.32
134	-11	Росэнергобанк	2211	Москва и обл.	31406533	31213655	192878	0.62
135	0	Банк «МБА-Москва»	3395	Москва и обл.	31278606	26984069	4294537	15.92
136	46	Финпромбанк (ФПБ Банк)	2157	Москва и обл.	31191647	18201287	12990360	71.37
137	-10	АМБ Банк	3036	Москва и обл.	31063753	30548411	515342	1.69
138	-18	Кедр	1574	Красноярский край	30798956	32501996	-1703040	-5.24
139	-6	Банк АВБ	23	Самарская обл.	30507993	28487685	2020308	7.09
140	37	Фольксваген Банк Рус	3500	Москва и обл.	30265745	18986393	11279352	59.41
141	-4	Агропромкредит	2880	Москва и обл.	30248298	26223366	4024932	15.35
142	-36	Дальневосточный Банк	843	Приморский край	30140721	37625908	-7485187	-19.89
143	-18	Банк СГБ	2816	Вологодская обл.	28818306	30741231	-1922925	-6.26
144	26	ББР Банк	2929	Москва и обл.	28714379	20723965	7990414	38.56
145	73	Западный	2598	Москва и обл.	28658238	14828732	13829506	93.26
146	9	Девон-Кредит	1972	Татарстан	28065451	22733317	5332134	23.46
147	-11	Липецккомбанк	1242	Липецкая обл.	27516241	26402539	1113702	4.22
148	5	Региональный Кредит	1927	Костромская обл.	26659867	23050219	3609648	15.66
149	23	Мосстройэкономбанк (М Банк)	948	Москва и обл.	26614801	20562995	6051806	29.43
150	-38	Национальный Резервный Банк	2170	Москва и обл.	26589118	33780775	-7191657	-21.29
151	-2	Акибанк	2587	Татарстан	26489887	23921588	2568299	10.74
152	-2	Русстройбанк	3205	Москва и обл.	26103590	23708325	2395265	10.1
153	552	Лето Банк	650	Москва и обл.	25950019	1195546	24754473	2070.56
154	-8	М2М Прайвет Банк	1414	Москва и обл.	25088051	24567866	520185	2.12
155	10	Первый Чешско-Российский Банк	3291	Москва и обл.	25047136	21436247	3610889	16.84
156	59	Военно-Промышленный Банк	3065	Москва и обл.	25006411	15213889	9792522	64.37
157	6	Сумитомо Мицуи	3494	Москва и обл.	24302419	21594408	2708011	12.54
158	6	Уральский Финансовый Дом	249	Пермская обл.	24206661	21588683	2617978	12.13
159	8	С банк	2581	Москва и обл.	24057620	21123385	2934235	13.89
160	-18	Приморье	3001	Приморский край	23836631	24954473	-1117842	-4.48
161	0	Кредит Урал Банк	2584	Челябинская обл.	23819980	22108278	1711702	7.74
162	-3	Альта-Банк	2269	Москва и обл.	23709959	22365215	1344744	6.01
163	-7	БМВ Банк	3482	Москва и обл.	23595726	22730847	864879	3.8
164	-23	Натиксис Банк	3390	Москва и обл.	23512002	25041123	-1529121	-6.11
165	-22	Стройкредит	18	Москва и обл.	23451074	24943669	-1492595	-5.98
166	-37	Мой Банк	2939	Москва и обл.	23427218	30008324	-6581106	-21.93
167	-22	Банк Проектного Финансирования	1677	Москва и обл.	23125290	24652566	-1527276	-6.2
168	37	Балтика	967	Санкт-Петербург и обл.	23023435	15718020	7305415	46.48
169	175	Банк Финсервис	3388	Москва и обл.	22577302	6463743	16113559	249.29
170	-10	Москоммерцбанк	3365	Москва и обл.	22550248	22359444	190804	0.85
171	114	Транспортный	3174	Москва и обл.	22374155	8952686	13421469	149.92
172	21	Мерседес-Бенц Банк Рус	3473	Москва и обл.	21458325	16812884	4645441	27.63
173	1	Спурт Банк	2207	Татарстан	21414354	20139870	1274484	6.33
174	13	Интехбанк	2705	Татарстан	21188830	17432545	3756285	21.55
175	39	Алеф-Банк	2119	Москва и обл.	21081348	15260917	5820431	38.14
176	9	Легион	3117	Москва и обл.	20975421	17683334	3292087	18.62
177	-1	Огни Москвы	2328	Москва и обл.	20880666	19183291	1697375	8.85
178	-9	Тимер Банк	1581	Татарстан	20738434	20797227	-58793	-0.28
179	11	БКС — Инвестиционный Банк	101	Новосибирская обл.	20713116	17199380	3513736	20.43
180	-12	ФИА-Банк	2542	Самарская обл.	20531826	20963897	-432071	-2.06
181	-33	ГПБ-Ипотека	2403	Москва и обл.	19979033	24107144	-4128111	-17.12
182	-11	Европейский Трастовый Банк	2968	Москва и обл.	19937820	20585573	-647753	-3.15
183	-4	Пойдем!	2534	Москва и обл.	19409673	18711513	698160	3.73
184	2	Уралтрансбанк	812	Свердловская обл.	19308229	17490860	1817369	10.39
185	36	Гута-Банк	256	Москва и обл.	19207030	14371106	4835924	33.65
186	34	АйМаниБанк	1975	Москва и обл.	19170401	14629717	4540684	31.04
187	24	Ланта-Банк	1920	Москва и обл.	19121179	15378484	3742695	24.34
188	9	Морской Банк	77	Москва и обл.	19112394	16417200	2695194	16.42
189	21	АктивКапитал Банк	3006	Самарская обл.	19075837	15455177	3620660	23.43
190	4	Фининвест	671	Санкт-Петербург и обл.	18974389	16746806	2227583	13.3
191	-2	Энергобанк	67	Татарстан	18648817	17321813	1327004	7.66
192	14	Энерготрансбанк	1307	Калининградская обл.	18622090	15669868	2952222	18.84
193	14	Эллипс Банк	1950	Нижегородская обл.	18565798	15535467	3030331	19.51
194	-2	Алмазэргиэнбанк	2602	Саха (Якутия)	18534576	17019120	1515456	8.9
195	27	АйСиБиСи Банк	3475	Москва и обл.	18103025	14266435	3836590	26.89
196	-1	Держава	2738	Москва и обл.	18092837	16605547	1487290	8.96
197	-22	Платежный Центр	3166	Новосибирская обл.	17995165	19416566	-1421401	-7.32
198	-41	Солидарность (Самара)	554	Самарская обл.	17959410	22593245	-4633835	-20.51
199	-1	Норвик Банк	902	Кировская обл.	17818047	16372668	1445379	8.83
200	47	Транснациональный Банк	2108	Москва и обл.	17759620	11217950	6541670	58.31
201	-2	Первомайский	518	Краснодарский край	17503471	16359847	1143624	6.99
202	0	НБД-Банк	1966	Нижегородская обл.	17365477	15936472	1429005	8.97
203	-20	Инвесткапиталбанк	2377	Башкортостан	17294981	17961380	-666399	-3.71
204	-4	Форштадт	2208	Оренбургская обл.	17243308	16112200	1131108	7.02
205	-1	Курскпромбанк	735	Курская обл.	17050505	15756327	1294178	8.21
206	-26	Развитие-Столица	3013	Москва и обл.	17038364	18683403	-1645039	-8.8
207	24	СтарБанк	548	Москва и обл.	16867834	12836814	4031020	31.4
208	-7	Газэнергобанк	3252	Калужская обл.	16735431	15997567	737864	4.61
209	10	Гаранти Банк — Москва	3275	Москва и обл.	16531573	14688758	1842815	12.55
210	22	Московское Ипотечное Агентство	3344	Москва и обл.	16389433	12818771	3570662	27.85
211	-23	Тольяттихимбанк	2507	Самарская обл.	16279499	17376643	-1097144	-6.31
212	-34	Петербургский Социальный Коммерческий Банк	2551	Санкт-Петербург и обл.	15989992	18949629	-2959637	-15.62
213	71	Данске Банк	3307	Санкт-Петербург и обл.	15463422	9011509	6451913	71.6
214	43	Рублев	3098	Москва и обл.	15449882	10486250	4963632	47.33
215	-19	Плюс Банк	1189	Омская обл.	15321448	16455062	-1133614	-6.89
216	-8	Новокузнецкий Муниципальный Банк	2865	Кемеровская обл.	15284484	15488038	-203554	-1.31
217	-26	МАСТ-Банк	3267	Москва и обл.	15235557	17060142	-1824585	-10.7
218	16	Национальный Банк Развития Бизнеса	2795	Москва и обл.	15161854	12680992	2480862	19.56
219	-7	Александровский	53	Санкт-Петербург и обл.	15108925	15353895	-244970	-1.6
220	7	Росдорбанк	1573	Москва и обл.	14984766	13324452	1660314	12.46
221	7	Гранд Инвест Банк	3053	Москва и обл.	14912696	13203122	1709574	12.95
222	78	Русский Земельный Банк	2810	Москва и обл.	14851950	8130534	6721416	82.67
223	1	Национальная Факторинговая Компания	3437	Москва и обл.	14836306	13770922	1065384	7.74
224	9	Интрастбанк	3144	Москва и обл.	14802350	12743108	2059242	16.16
225	1	Хлынов	254	Кировская обл.	14602887	13406869	1196018	8.92
226	-13	Нацинвестпромбанк	3077	Москва и обл.	14596325	15282789	-686464	-4.49
227	-11	ВУЗ-Банк	1557	Свердловская обл.	14506329	15080819	-574490	-3.81
228	2	СИАБ	3245	Санкт-Петербург и обл.	14356208	12839605	1516603	11.81
229	60	Монолит	1967	Москва и обл.	14348171	8646743	5701428	65.94
230	25	Банк Город	2644	Москва и обл.	13862951	10582321	3280630	31
231	12	Банк Расчетов и Сбережений	2617	Москва и обл.	13774839	11652746	2122093	18.21
232	5	Расчетно-Кредитный Банк	103	Москва и обл.	13634688	12561800	1072888	8.54
233	5	Банк24.ру	2227	Свердловская обл.	13571888	12478188	1093700	8.76
234	31	БайкалБанк	2632	Бурятия	13498424	10102529	3395895	33.61
235	-10	ТЭМБР-Банк	2764	Москва и обл.	13477949	13553565	-75616	-0.56
236	25	Социнвестбанк	1132	Башкортостан	13094309	10303350	2790959	27.09
237	8	РусЮгбанк	2093	Волгоградская обл.	13068442	11434197	1634245	14.29
238	-15	Центркомбанк	2983	Москва и обл.	12991430	13824629	-833199	-6.03
239	-22	Банк ПСА Финанс Рус	3481	Москва и обл.	12784422	14885073	-2100651	-14.11
240	18	Европейский	1616	Калининградская обл.	12735327	10463742	2271585	21.71
241	19	НК Банк	2755	Москва и обл.	12689145	10339231	2349914	22.73
242	12	Акцепт	567	Новосибирская обл.	12651546	10584803	2066743	19.53
243	52	Клиентский	2324	Москва и обл.	12546241	8436679	4109562	48.71
244	-5	Солидарность (Москва)	1555	Москва и обл.	12520199	12475429	44770	0.36
245	-61	Аресбанк	2914	Москва и обл.	12454084	17818591	-5364507	-30.11
246	13	Метробанк	2548	Москва и обл.	12397232	10402259	1994973	19.18
247	1	Росавтобанк	2767	Москва и обл.	12271121	11154019	1117102	10.02
248	1	Русский Ипотечный Банк	1968	Москва и обл.	12250066	11111628	1138438	10.25
249	19	Росэксимбанк	2790	Москва и обл.	12149136	9873735	2275401	23.04
250	53	Тусар	2712	Москва и обл.	12082930	8021170	4061760	50.64
251	1	ОФК Банк	2270	Москва и обл.	11996258	10639915	1356343	12.75
252	-11	Денизбанк Москва	3330	Москва и обл.	11990711	11913483	77228	0.65
253	144	Анталбанк	3115	Москва и обл.	11674444	4971153	6703291	134.84
254	-45	Энергомашбанк	52	Санкт-Петербург и обл.	11671396	15484869	-3813473	-24.63
255	-2	Унифин	2654	Москва и обл.	11641164	10620950	1020214	9.61
256	101	Объединенный Капитал	2611	Санкт-Петербург и обл.	11622261	5925715	5696546	96.13
257	-6	Экономбанк	1319	Саратовская обл.	11558722	11021408	537314	4.88
258	18	Гарант-Инвест	2576	Москва и обл.	11342653	9457839	1884814	19.93
259	-15	Прио-Внешторгбанк	212	Рязанская обл.	11302579	11537147	-234568	-2.03
260	60	Автоторгбанк	2776	Москва и обл.	11212797	7321589	3891208	53.15
261	1	Екатеринбург	3161	Свердловская обл.	10960091	10290878	669213	6.5
262	7	Оренбург	3269	Оренбургская обл.	10955522	9828474	1127048	11.47
263	-27	Экопромбанк	2011	Пермская обл.	10886255	12584709	-1698454	-13.5
264	-22	ЯР-Банк	3185	Москва и обл.	10844948	11692598	-847650	-7.25
265	-30	Адмиралтейский	3054	Москва и обл.	10693694	12624824	-1931130	-15.3
266	57	Хованский	2145	Москва и обл.	10657465	7181670	3475795	48.4
267	178	Стратегия	2801	Москва и обл.	10465209	3681186	6784023	184.29
268	63	ЕвроситиБанк	1869	Москва и обл.	10445278	6904616	3540662	51.28
269	-3	Международный Акционерный Банк	1987	Москва и обл.	10379267	9923102	456165	4.6
270	44	Солид Банк	1329	Камчатская обл.	10371273	7672070	2699203	35.18
271	47	Дил-Банк	3384	Москва и обл.	10325202	7453972	2871230	38.52
272	8	Темпбанк	55	Москва и обл.	10305166	9071234	1233932	13.6
273	-2	СЭБ Банк	3235	Санкт-Петербург и обл.	10269705	9791640	478065	4.88
274	17	Башкомснаббанк	1398	Башкортостан	10178361	8569313	1609048	18.78
275	-5	Международный Банк Развития	2704	Москва и обл.	10168226	9809226	359000	3.66
276	307	Компания Розничного Кредитования	3385	Москва и обл.	10147385	2057002	8090383	393.31
277	32	Банк Жилищного Финансирования	3138	Москва и обл.	10134824	7847712	2287112	29.14
278	24	Башинвестбанк	2189	Башкортостан	10105679	8030775	2074904	25.84
279	14	ОПМ-Банк	2734	Москва и обл.	10000565	8531257	1469308	17.22
280	-13	Нефтяной Альянс	2859	Москва и обл.	9943279	9921805	21474	0.22
281	15	Руснарбанк	3403	Москва и обл.	9863813	8379849	1483964	17.71
282	68	Татсоцбанк	480	Татарстан	9719995	6120184	3599811	58.82
283	24	Тихоокеанский Внешторгбанк	1378	Сахалинская обл.	9649414	7906678	1742736	22.04
284	-44	Углеметбанк	2997	Челябинская обл.	9633341	12084453	-2451112	-20.28
285	27	Русьуниверсалбанк	3293	Москва и обл.	9631529	7691532	1939997	25.22
286	-11	Генбанк	2490	Москва и обл.	9541513	9475951	65562	0.69
287	-14	Кредит-Москва	5	Москва и обл.	9520812	9558824	-38012	-0.4
288	-42	Миллениум Банк	3423	Москва и обл.	9494891	11358239	-1863348	-16.41
289	-6	Ю Би Эс Банк	3463	Москва и обл.	9180619	9026843	153776	1.7
290	2	Роспромбанк	3204	Москва и обл.	9107620	8551038	556582	6.51
291	87	Кузнецкий Мост	2254	Москва и обл.	8935889	5396124	3539765	65.6
292	9	Нико-Банк	702	Оренбургская обл.	8932302	8100565	831737	10.27
293	-37	Промсбербанк	1043	Москва и обл.	8853192	10498334	-1645142	-15.67
294	5	КС Банк	1752	Мордовия	8838752	8133097	705655	8.68
295	-16	Белгородсоцбанк	760	Белгородская обл.	8787329	9097064	-309735	-3.4
296	28	Промтрансбанк	2638	Башкортостан	8767131	7145224	1621907	22.7
297	-68	Бэнк оф Чайна	2309	Москва и обл.	8722283	12986973	-4264690	-32.84
298	-12	Новосибирский Муниципальный Банк	2786	Новосибирская обл.	8705017	8930724	-225707	-2.53
299	-22	Евромет	2902	Москва и обл.	8664849	9169335	-504486	-5.5
300	-134	Мир Бизнес Банк	3396	Москва и обл.	8654163	21241316	-12587153	-59.26
301	-51	Киви Банк	2241	Москва и обл.	8562852	11033359	-2470507	-22.39
302	19	Бенифит-Банк	3229	Москва и обл.	8380914	7303455	1077459	14.75
303	26	Агросоюз	1459	Москва и обл.	8328944	7006132	1322812	18.88
304	4	Экспресс-Кредит	210	Москва и обл.	8288304	7864573	423731	5.39
305	-7	Волга-Кредит	1153	Самарская обл.	8245210	8288274	-43064	-0.52
306	-19	Банк Торгового Финансирования	1982	Москва и обл.	8060522	8687271	-626749	-7.21
307	21	Финам Банк	2799	Москва и обл.	8055276	7051267	1004009	14.24
308	7	ПИР Банк	2655	Москва и обл.	8017513	7613387	404126	5.31
309	30	Рускобанк	138	Санкт-Петербург и обл.	8006540	6592559	1413981	21.45
310	-16	Славия	2664	Москва и обл.	7993827	8529341	-535514	-6.28
311	27	Ишбанк	2867	Москва и обл.	7965696	6593528	1372168	20.81
312	-24	Уралкапиталбанк	2519	Башкортостан	7806536	8670571	-864035	-9.97
313	68	Нижневолжский Коммерческий Банк	931	Саратовская обл.	7743313	5362121	2381192	44.41
314	-50	МАК-Банк	1088	Москва и обл.	7736932	10217342	-2480410	-24.28
315	-9	Снежинский	1376	Челябинская обл.	7708022	7979173	-271151	-3.4
316	-11	АФ Банк	991	Башкортостан	7674021	7992720	-318699	-3.99
317	17	Развитие	2729	Карачаево-Черкесия	7638600	6763213	875387	12.94
318	1	Финансовый Стандарт	1053	Москва и обл.	7594743	7410290	184453	2.49
319	44	Бинбанк Мурманск	1276	Мурманская обл.	7594503	5762538	1831965	31.79
320	10	Япы Креди Банк Москва	2555	Москва и обл.	7471739	6953086	518653	7.46
321	50	Тройка-Д Банк	3431	Москва и обл.	7454761	5537034	1917727	34.63
322	29	Софрино	2972	Москва и обл.	7382253	6082772	1299481	21.36
323	81	Спецсетьстройбанк	3062	Москва и обл.	7346527	4875287	2471240	50.69
324	-7	Кузнецкбизнесбанк	1158	Кемеровская обл.	7325652	7527837	-202185	-2.69
325	0	Ренессанс	1939	Москва и обл.	7241190	7137163	104027	1.46
326	32	Московский Нефтехимический Банк	1411	Москва и обл.	7233504	5925420	1308084	22.08
327	-1	Ижкомбанк	646	Удмуртия	7229079	7104991	124088	1.75
328	20	ФДБ	3071	Москва и обл.	7210022	6253546	956476	15.29
329	27	Альба Альянс	2593	Москва и обл.	7183820	5936749	1247071	21.01
330	-17	Банк БЦК-Москва	3480	Москва и обл.	7137375	7684888	-547513	-7.12
331	2	Томскпромстройбанк	1720	Томская обл.	7130012	6795472	334540	4.92
332	-21	Северо-Восточный Альянс	2768	Москва и обл.	7115907	7709701	-593794	-7.7
333	-11	Ставропольпромстройбанк	1288	Ставропольский край	7108305	7273838	-165533	-2.28
334	50	Трансстройбанк	2807	Москва и обл.	7063299	5238623	1824676	34.83
335	50	Банк БКФ	2684	Москва и обл.	7018014	5190754	1827260	35.2
336		Чайна Констракшн	3515	Москва и обл.	7015153			
337	45	Джей энд Ти Банк	3061	Москва и обл.	7009718	5242071	1767647	33.72
338	-2	Эксперт Банк	2949	Омская обл.	6939467	6646923	292544	4.4
339	15	Славянский Кредит	2960	Москва и обл.	6925022	6065674	859348	14.17
340	-59	Платина	2347	Москва и обл.	6920554	9048345	-2127791	-23.52
341	135	Уральский Межрегиональный Банк	1441	Свердловская обл.	6919593	3190911	3728682	116.85
342	4	Юг-Инвестбанк	2772	Краснодарский край	6884114	6374495	509619	7.99
343	85	Еврокоммерц	1777	Москва и обл.	6867187	4221411	2645776	62.68
344	43	Навигатор	2469	Москва и обл.	6821057	5146220	1674837	32.54
345	15	Русский Торговый Банк	2842	Москва и обл.	6790029	5919150	870879	14.71
346	42	Торгово-Строительный Банк	1250	Москва и обл.	6789087	5143368	1645719	32
347	-7	Русь	704	Оренбургская обл.	6711276	6556023	155253	2.37
348	292	Инвестиционный Республиканский Банк	2571	Москва и обл.	6697953	1593591	5104362	320.31
349	64	Новопокровский	467	Краснодарский край	6672736	4555348	2117388	46.48
350	-5	Муниципальный Камчатпрофитбанк	2103	Камчатская обл.	6662334	6377841	284493	4.46
351	15	Вокбанк	312	Нижегородская обл.	6646031	5680431	965600	17
352	31	Банк БФТ	2273	Москва и обл.	6620442	5240576	1379866	26.33
353	11	Ассоциация	732	Нижегородская обл.	6597344	5707992	889352	15.58
354	49	2Т Банк	625	Москва и обл.	6587786	4894189	1693597	34.6
355	-14	Новый Московский Банк	2932	Москва и обл.	6526165	6535062	-8897	-0.14
356	-21	Банк Инноваций и Развития	2647	Москва и обл.	6526009	6686781	-160772	-2.4
357	-15	Автоградбанк	1455	Татарстан	6446808	6532475	-85667	-1.31
358	33	Экономикс-Банк	2136	Москва и обл.	6441787	5096526	1345261	26.4
359	121	Кроссинвестбанк	2849	Москва и обл.	6394677	3125920	3268757	104.57
360	-11	Бинбанк Тверь	777	Тверская обл.	6380242	6204013	176229	2.84
361	-24	Банк Казани	708	Татарстан	6355776	6616443	-260667	-3.94
362	11	Голдман Сакс Банк	3490	Москва и обл.	6252316	5446588	805728	14.79
363	7	Инвестиционный Союз	637	Москва и обл.	6250044	5545037	705007	12.71
364	61	Эл Банк	1025	Самарская обл.	6166111	4259154	1906957	44.77
365	-22	Национальный Залоговый Банк	2944	Москва и обл.	6150576	6486157	-335581	-5.17
366	30	Анкор Банк	889	Татарстан	6057795	4979595	1078200	21.65
367	-70	Замоскворецкий	1640	Москва и обл.	6016481	8377491	-2361010	-28.18
368	12	Нэклис-Банк	1671	Москва и обл.	5961911	5364076	597835	11.15
369	-1	Объединенный Банк Промышленных Инвестиций	2626	Москва и обл.	5949034	5614996	334038	5.95
370	-15	Ури Банк	3479	Москва и обл.	5921853	6040363	-118510	-1.96
371	-4	Региональный Банк Развития	2782	Башкортостан	5870800	5631395	239405	4.25
372	22	Камский Коммерческий Банк	438	Татарстан	5816202	5027129	789073	15.7
373	37	Кранбанк	2271	Ивановская обл.	5807911	4675397	1132514	24.22
374	-21	Банк на Красных Воротах	2472	Москва и обл.	5781081	6071174	-290093	-4.78
375	-3	Актив Банк	2529	Мордовия	5776845	5447098	329747	6.05
376	-1	Северный Народный Банк	2721	Коми	5765142	5427209	337933	6.23
377	24	Нефтепромбанк	2156	Москва и обл.	5755216	4939644	815572	16.51
378	-4	Таатта	1249	Саха (Якутия)	5727655	5446346	281309	5.17
379	11	Мой Банк. Ипотека	2436	Башкортостан	5708421	5109247	599174	11.73
380	40	Проминвестбанк	2433	Москва и обл.	5692343	4442240	1250103	28.14
381	-49	Дагэнергобанк	3286	Дагестан	5642813	6856836	-1214023	-17.71
382	380	РН Банк	170	Москва и обл.	5626974	879242	4747732	539.98
383	23	Промэнергобанк	2728	Вологодская обл.	5615528	4775129	840399	17.6
384	8	Век	2299	Москва и обл.	5610824	5074244	536580	10.57
385	-23	Веста	2368	Москва и обл.	5570273	5778680	-208407	-3.61
386	-70	Современный Коммерческий Ипотечный Банк	3329	Москва и обл.	5533639	7564130	-2030491	-26.84
387	-105	Объединенная Расчетная Система	3342	Москва и обл.	5529855	9026993	-3497138	-38.74
388	-11	Чувашкредитпромбанк	1280	Чувашия	5494318	5398643	95675	1.77
389	-115	Вега-Банк	3270	Москва и обл.	5446004	9509517	-4063513	-42.73
390	-25	Сибнефтебанк	385	Тюменская обл.	5435155	5696454	-261299	-4.59
391	77	Азия-Инвест Банк	3303	Москва и обл.	5428200	3261941	2166259	66.41
392	83	Эргобанк	2856	Москва и обл.	5367728	3194083	2173645	68.05
393	19	Стройлесбанк	2995	Тюменская обл.	5350713	4578239	772474	16.87
394	-84	Международный Коммерческий Банк	2524	Москва и обл.	5341395	7735466	-2394071	-30.95
395	12	БайкалИнвестБанк	1067	Иркутская обл.	5298942	4721077	577865	12.24
396	-7	Зернобанк	2337	Алтайский край	5292642	5111794	180848	3.54
397	36	Банк ИТБ	3128	Москва и обл.	5258845	4057011	1201834	29.62
398	-29	Сибсоцбанк	2015	Алтайский край	5251736	5599210	-347474	-6.21
399	90	Невский Банк	1068	Санкт-Петербург и обл.	5247569	2984865	2262704	75.81
400	-24	Риабанк	3434	Москва и обл.	5240005	5421660	-181655	-3.35
401	-15	Бинбанк Смоленск	1957	Смоленская обл.	5220451	5174008	46443	0.9
402	-98	Экси-Банк	2530	Санкт-Петербург и обл.	5210137	8006252	-2796115	-34.92
403	19	Зенит Сочи	232	Краснодарский край	5171158	4387527	783631	17.86
404	1	Юникорбанк	2586	Москва и обл.	5132312	4824350	307962	6.38
405	9	Банкхаус Эрбе	1717	Москва и обл.	5056938	4552901	504037	11.07
406	56	Церих	3278	Орловская обл.	5056274	3338331	1717943	51.46
407	-9	Банк Развития Технологий	3441	Москва и обл.	5018423	4964824	53599	1.08
408	8	Северный Кредит	2398	Вологодская обл.	5012982	4506860	506122	11.23
409	6	ВостСибтранскомбанк	2731	Иркутская обл.	5009537	4531810	477727	10.54
410	73	Горбанк	2982	Санкт-Петербург и обл.	4991110	3092714	1898396	61.38
411	7	Ермак	1809	Тюменская обл.	4965536	4451752	513784	11.54
412	11	Межрегиональный Почтовый Банк	3171	Москва и обл.	4943787	4354845	588942	13.52
413	-18	Объединенный Кредитный Банк	1118	Владимирская обл.	4901455	4990028	-88573	-1.78
414	35	РЕСО Кредит	3450	Москва и обл.	4877017	3569934	1307083	36.61
415	136	Инбанк	1829	Москва и обл.	4822531	2303950	2518581	109.32
416	8	Хакасский Муниципальный Банк	1049	Хакасия	4781996	4351068	430928	9.9
417	42	Финансовый Капитал	3288	Санкт-Петербург и обл.	4747572	3393995	1353577	39.88
418	34	Мосуралбанк	2468	Москва и обл.	4740484	3492711	1247773	35.73
419	16	Тюменьагропромбанк	917	Тюменская обл.	4734916	3988248	746668	18.72
420	-27	Межтрастбанк	2493	Москва и обл.	4710156	5042517	-332361	-6.59
421	245	Европлан Банк	3052	Москва и обл.	4698341	1402214	3296127	235.07
422	9	Оргбанк	3312	Москва и обл.	4671951	4064900	607051	14.93
423	3	Нейва	1293	Свердловская обл.	4667139	4255335	411804	9.68
424	-72	Руссобанк	2313	Москва и обл.	4661294	6073028	-1411734	-23.25
425	22	Москва-Сити	3247	Москва и обл.	4630270	3636618	993652	27.32
426	-65	Банк Оранжевый	1659	Санкт-Петербург и обл.	4607416	5888419	-1281003	-21.75
427	-6	Газстройбанк	2919	Москва и обл.	4602418	4431046	171372	3.87
428	-29	Кремлевский	2905	Москва и обл.	4564309	4950967	-386658	-7.81
429	0	Универсальный Кредит	2903	Москва и обл.	4494573	4141775	352798	8.52
430	-30	Лесбанк	1598	Москва и обл.	4488632	4944462	-455830	-9.22
431	-22	Донкомбанк	492	Ростовская обл.	4486519	4693369	-206850	-4.41
432	14	Кузнецкий	609	Пензенская обл.	4459068	3673086	785982	21.4
433	7	Межрегиональный промышленно-строительный банк	752	Мордовия	4428257	3852660	575597	14.94
434	114	Верхневолжский	1084	Ярославская обл.	4418740	2335539	2083201	89.2
435	2	Заречье	817	Татарстан	4412874	3940289	472585	11.99
436	-89	Волжский Социальный Банк	2428	Самарская обл.	4314283	6266017	-1951734	-31.15
437	-110	Профит Банк	3234	Москва и обл.	4279430	7057926	-2778496	-39.37
438	85	Система	2846	Москва и обл.	4269214	2589103	1680111	64.89
439	5	Союзный	3236	Москва и обл.	4230966	3683595	547371	14.86
440	-21	Енисейский Объединенный Банк	2645	Красноярский край	4173379	4449272	-275893	-6.2
441	19	Русский Трастовый Банк	1139	Москва и обл.	4157583	3374014	783569	23.22
442	0	Интернациональный Торговый Банк	2609	Омская обл.	4105437	3711447	393990	10.62
443	13	Синко-Банк	2838	Москва и обл.	4100313	3440678	659635	19.17
444	-6	Новобанк	1352	Новгородская обл.	4096782	3929257	167525	4.26
445	18	Роял Кредит Банк	783	Хабаровский край	4096137	3334439	761698	22.84
446	-7	Земский Банк	2900	Самарская обл.	4095097	3891575	203522	5.23
447	-13	Промрегионбанк	2123	Томская обл.	4029150	4046251	-17101	-0.42
448	61	Мираф-Банк	2244	Омская обл.	3995914	2785128	1210786	43.47
449	-8	Мастер-Капитал	3011	Москва и обл.	3907685	3798719	108966	2.87
450	-42	Банк Раунд	2506	Москва и обл.	3880090	4693565	-813475	-17.33
451	124	Конфидэнс Банк	970	Костромская обл.	3858614	2140557	1718057	80.26
452	58	Элита	1399	Калужская обл.	3832898	2753768	1079130	39.19
453	-5	Милбанк	3256	Москва и обл.	3805851	3586579	219272	6.11
454	12	Сити Инвест Банк	3194	Санкт-Петербург и обл.	3784163	3280314	503849	15.36
455	14	Алтайкапиталбанк	2659	Алтайский край	3765819	3257159	508660	15.62
456	112	Идея Банк	430	Краснодарский край	3753790	2178277	1575513	72.33
457	8	Витабанк	356	Санкт-Петербург и обл.	3717574	3290234	427340	12.99
458	-7	Камчаткомагропромбанк	545	Камчатская обл.	3715523	3511609	203914	5.81
459	34	Наш Дом	3296	Москва и обл.	3672761	2959710	713051	24.09
460	-5	Консервативный Коммерческий Банк	1087	Астраханская обл.	3659090	3455342	203748	5.9
461	18	Интеркредит	3047	Москва и обл.	3647997	3138695	509302	16.23
462	22	Банк Экономический Союз	2798	Москва и обл.	3627453	3083996	543457	17.62
463	51	Московский Коммерческий Банк	3172	Москва и обл.	3623845	2710442	913403	33.7
464	17	РБА	3413	Москва и обл.	3589809	3120904	468905	15.02
465	5	Форус Банк	3457	Нижегородская обл.	3583004	3252138	330866	10.17
466	1	Еврокредит	2957	Москва и обл.	3551486	3276078	275408	8.41
467	31	Коммерческий Индо Банк	3446	Москва и обл.	3539751	2887631	652120	22.58
468	73	Ваш Личный Банк	1222	Иркутская обл.	3534789	2409947	1124842	46.67
469	-8	Живаго-Банк	2065	Рязанская обл.	3521799	3343430	178369	5.33
470	-27	Евроальянс	1781	Ивановская обл.	3519171	3686806	-167635	-4.55
471	79	Промсельхозбанк	538	Москва и обл.	3485733	2326553	1159180	49.82
472	1	Интерактивный Банк	3378	Москва и обл.	3484761	3227967	256794	7.96
473	22	Финансово-Промышленный Капитал	3295	Москва и обл.	3471087	2939915	531172	18.07
474	213	Финанс Бизнес Банк	520	Краснодарский край	3463501	1281011	2182490	170.37
475	125	Леноблбанк	1003	Санкт-Петербург и обл.	3460459	1897217	1563242	82.4
476	-22	Сберинвестбанк	1743	Свердловская обл.	3451679	3471116	-19437	-0.56
477	-19	Долинск	857	Сахалинская обл.	3447437	3415496	31941	0.94
478	54	Итуруп	2390	Сахалинская обл.	3411441	2487700	923741	37.13
479	15	Аксонбанк	680	Костромская обл.	3409972	2950767	459205	15.56
480	-27	Крыловский	456	Краснодарский край	3397484	3491623	-94139	-2.7
481	7	Профессионал Банк	2471	Москва и обл.	3397238	3004695	392543	13.06
482	106	Торговый Городской Банк	3180	Тверская обл.	3392096	2021312	1370784	67.82
483	-6	Океан Банк	1697	Москва и обл.	3390401	3170499	219902	6.94
484	125	Лайтбанк	3177	Москва и обл.	3362840	1834375	1528465	83.32
485	21	Сибирский Банк Реконструкции и Развития	1284	Тюменская обл.	3334019	2842366	491653	17.3
486	-4	Уралпромбанк	2964	Челябинская обл.	3329941	3095497	234444	7.57
487	245	МС Банк Рус	2789	Москва и обл.	3325230	1016364	2308866	227.17
488	-14	Тамбовкредитпромбанк	1312	Тамбовская обл.	3303472	3197276	106196	3.32
489	13	Уссури	596	Хабаровский край	3289791	2861112	428679	14.98
490	115	РТС-Банк	3401	Самарская обл.	3280451	1864304	1416147	75.96
491	125	Бест Эффортс Банк	435	Москва и обл.	3274355	1783089	1491266	83.63
492	-6	Венец	524	Ульяновская обл.	3237401	3051754	185647	6.08
493	-36	Смартбанк	3408	Москва и обл.	3199577	3428500	-228923	-6.68
494	-83	Донинвест	1617	Ростовская обл.	3166761	4611348	-1444587	-31.33
495	9	ЕвроАксис Банк	3273	Москва и обл.	3135613	2850108	285505	10.02
496	49	Владпромбанк	870	Владимирская обл.	3132673	2343546	789127	33.67
497	-65	Бинбанк Сургут	1701	Тюменская обл.	3128602	4062464	-933862	-22.99
498	19	Вологжанин	1896	Вологодская обл.	3036563	2689704	346859	12.9
499	-8	НБК-Банк	3283	Москва и обл.	2988795	2963238	25557	0.86
500	20	Коммерческий Банк Развития	3364	Москва и обл.	2982909	2613516	369393	14.13
501	-9	Гринфилдбанк	2711	Москва и обл.	2969342	2961641	7701	0.26
502	5	Енисей	474	Красноярский край	2962620	2790590	172030	6.16
503	117	Унифондбанк	3416	Москва и обл.	2959384	1751316	1208068	68.98
504	-7	Нокссбанк	3202	Волгоградская обл.	2948927	2899375	49552	1.71
505	20	Агророс	2860	Саратовская обл.	2929045	2570558	358487	13.95
506	10	Костромаселькомбанк	1115	Костромская обл.	2923772	2697774	225998	8.38
507	199	Индустриальный Сберегательный Банк	3175	Москва и обл.	2916302	1179238	1737064	147.3
508	-18	Гагаринский	606	Москва и обл.	2904476	2970744	-66268	-2.23
509	-79	Приоритет	3135	Самарская обл.	2890446	4128113	-1237667	-29.98
510	61	Северо-Западный 1 Альянс Банк	766	Санкт-Петербург и обл.	2885840	2165788	720052	33.25
511	-109	Аскольд	2480	Смоленская обл.	2850962	4925235	-2074273	-42.12
512	19	Банк РМП	2574	Москва и обл.	2827789	2514757	313032	12.45
513	-10	Преодоление	2649	Москва и обл.	2819366	2855967	-36601	-1.28
514	-78	Земкомбанк	574	Ростовская обл.	2809521	3943715	-1134194	-28.76
515	14	Диг-Банк	2423	Северная Осетия — Алания	2801972	2547168	254804	10
516	123	Народный Доверительный Банк	2374	Москва и обл.	2750171	1596725	1153446	72.24
517	2	ПК-Банк	2652	Нижегородская обл.	2741057	2674809	66248	2.48
518	22	Траст Капитал Банк	2741	Москва и обл.	2709174	2422954	286220	11.81
519	-23	Росбизнесбанк	1405	Москва и обл.	2700654	2908340	-207686	-7.14
520	92	Столичный Кредит	2853	Москва и обл.	2659831	1806621	853210	47.23
521	14	Богородский Муниципальный Банк	2992	Москва и обл.	2647998	2465433	182565	7.4
522	-17	ИпоТек Банк	2794	Москва и обл.	2645764	2845869	-200105	-7.03
523	47	РСКБ	2050	Москва и обл.	2634953	2165843	469110	21.66
524	48	Айви Банк	2055	Москва и обл.	2617263	2161699	455564	21.07
525	-13	Инвестсоцбанк	3010	Москва и обл.	2611921	2727777	-115856	-4.25
526	39	Братский АНКБ	1144	Иркутская обл.	2610117	2189175	420942	19.23
527	-3	Вкабанк	1027	Астраханская обл.	2608142	2575497	32645	1.27
528	-27	Риал-Кредит	3393	Москва и обл.	2602021	2862530	-260509	-9.1
529	50	Таурус Банк	655	Челябинская обл.	2597939	2100193	497746	23.7
530	52	Мегаполис	3265	Чувашия	2594276	2083083	511193	24.54
531	6	Резерв	2364	Челябинская обл.	2588347	2455400	132947	5.41
532	124	Русский Национальный Банк	469	Ростовская обл.	2573101	1465458	1107643	75.58
533	45	Проинвестбанк	784	Пермская обл.	2556269	2115161	441108	20.85
534	-4	Аспект	608	Москва и обл.	2553257	2522454	30803	1.22
535	96	Пурпе	709	Тюменская обл.	2539101	1647868	891233	54.08
536	2	МФБанк	3163	Москва и обл.	2538648	2447177	91471	3.74
537	-3	Констанс-Банк	2228	Санкт-Петербург и обл.	2537927	2471693	66234	2.68
538	138	Газтрансбанк	665	Адыгея	2534841	1338241	1196600	89.42
539	42	Радиотехбанк	1166	Нижегородская обл.	2533724	2091039	442685	21.17
540	19	Финтрастбанк	3104	Москва и обл.	2529179	2249380	279799	12.44
541	166	Заубер Банк	1614	Карачаево-Черкесия	2471846	1179185	1292661	109.62
542	-21	Богородский	1277	Нижегородская обл.	2467181	2612619	-145438	-5.57
543	13	Национальный Корпоративный Банк	3422	Москва и обл.	2463850	2257341	206509	9.15
544	-26	Капитал	575	Москва и обл.	2456452	2684188	-227736	-8.48
545	-58	Первый Инвестиционный банк	604	Москва и обл.	2453334	3026804	-573470	-18.95
546	-20	Национальный Банк Сбережений	1949	Ивановская обл.	2451803	2562036	-110233	-4.3
547	321	Кошелев-Банк	3300	Самарская обл.	2450465	415463	2035002	489.82
548	-5	Бум-Банк	1137	Кабардино-Балкария	2449950	2359237	90713	3.85
549	18	Иваново	1763	Ивановская обл.	2446950	2179622	267328	12.26
550	3	Объединенный Резервный Банк	937	Москва и обл.	2440652	2291966	148686	6.49
551	23	Пульс Столицы	3002	Москва и обл.	2429539	2142896	286643	13.38
552	34	Вестерн Юнион ДП Восток	2726	Москва и обл.	2421051	2031673	389378	19.17
553	-25	Витязь	2890	Москва и обл.	2409609	2559780	-150171	-5.87
554	-5	Крокус-Банк	2682	Москва и обл.	2386583	2333983	52600	2.25
555	9	Кубанский Универсальный Банк	2898	Краснодарский край	2380738	2193034	187704	8.56
556	-34	Апабанк	2404	Москва и обл.	2379610	2610032	-230422	-8.83
557	1	Зираат Банк	2559	Москва и обл.	2367237	2254629	112608	4.99
558	-19	ИК Банк	1732	Татарстан	2355213	2433742	-78529	-3.23
559	-26	ИРС	272	Москва и обл.	2350189	2478586	-128397	-5.18
560	20	КОР	2148	Волгоградская обл.	2326563	2098667	227896	10.86
561	28	Выборг-Банк	720	Санкт-Петербург и обл.	2318807	2014485	304322	15.11
562	25	Стелла-Банк	2948	Ростовская обл.	2310635	2029146	281489	13.87
563	-2	Йошкар-Ола	2802	Марий Эл	2303853	2239017	64836	2.9
564	-9	Яринтербанк	2564	Ярославская обл.	2300042	2268466	31576	1.39
565	32	Россита-Банк	3257	Москва и обл.	2287706	1940991	346715	17.86
566	18	Ринвестбанк	3262	Рязанская обл.	2272824	2046865	225959	11.04
567	71	Мострансбанк	2258	Москва и обл.	2266880	1601030	665850	41.59
568	-6	Пермь	875	Пермская обл.	2238918	2237968	950	0.04
569	-22	Союзпромбанк	2965	Москва и обл.	2227817	2336567	-108750	-4.65
570	26	Социум-Банк	2881	Москва и обл.	2226721	1943093	283628	14.6
571	36	Крона-Банк	2499	Иркутская обл.	2223638	1840124	383514	20.84
572	5	Кросна-Банк	2607	Москва и обл.	2216187	2117574	98613	4.66
573	59	Татагропромбанк	728	Татарстан	2210648	1640239	570409	34.78
574	63	Межбанковский Кредитный Союз	3242	Москва и обл.	2203586	1608352	595234	37.01
575	-90	Юнистрим	3467	Москва и обл.	2201910	3064868	-862958	-28.16
576	-24	Спиритбанк	2053	Тульская обл.	2193153	2295142	-101989	-4.44
577	-20	РФИ Банк	3351	Москва и обл.	2185832	2256165	-70333	-3.12
578	113	Банкирский Дом	2928	Санкт-Петербург и обл.	2182802	1256986	925816	73.65
579	213	Воронеж	654	Воронежская обл.	2175164	719760	1455404	202.21
580	11	Новация	840	Адыгея	2161844	2012280	149564	7.43
581	25	Банк МБФИ	2073	Москва и обл.	2156197	1842604	313593	17.02
582	-40	ФорБанк	2063	Алтайский край	2128848	2374775	-245927	-10.36
583	-119	Инкаробанк	2696	Москва и обл.	2126185	3318755	-1192570	-35.93
584	-48	Банк Сберегательно-кредитного сервиса	3224	Москва и обл.	2122252	2463396	-341144	-13.85
585	28	Владбизнесбанк	903	Владимирская обл.	2108239	1803129	305110	16.92
586	-86	Тульский Промышленник	2382	Тульская обл.	2090062	2875345	-785283	-27.31
587	-76	Евразийский Банк	969	Москва и обл.	2074923	2751279	-676356	-24.58
588	-44	Новый Символ	370	Москва и обл.	2073989	2348388	-274399	-11.68
589	12	Донхлеббанк	2285	Ростовская обл.	2044321	1895630	148691	7.84
590	-118	Тендер-Банк	2252	Москва и обл.	2025889	3242571	-1216682	-37.52
591	232	Межотраслевая Банковская Корпорация	3471	Москва и обл.	2025042	569721	1455321	255.44
592	34	Кредит Экспресс	3186	Ростовская обл.	2023140	1703280	319860	18.78
593	-85	Современные Стандарты Бизнеса	3397	Москва и обл.	2006152	2786682	-780530	-28.01
594	24	Интеркоопбанк	2803	Москва и обл.	1992349	1769649	222700	12.58
595	3	Нальчик	695	Кабардино-Балкария	1980540	1940400	40140	2.07
596	7	Викинг	2	Санкт-Петербург и обл.	1980326	1888547	91779	4.86
597	49	Канский	860	Красноярский край	1970971	1553513	417458	26.87
598	-83	Новое Время	3492	Москва и обл.	1969788	2701518	-731730	-27.09
599	-23	Дом-Банк	3209	Москва и обл.	1943443	2124650	-181207	-8.53
600	-37	Эльбин	2267	Дагестан	1940476	2222372	-281896	-12.68
601	23	Нарат	1902	Саратовская обл.	1929223	1719533	209690	12.19
602	51	Приобье	537	Тюменская обл.	1928396	1472147	456249	30.99
603	113	Мурманский Расчетный Центр	3341	Мурманская обл.	1914499	1107267	807232	72.9
604	40	Холмск	503	Сахалинская обл.	1913854	1583935	329919	20.83
605	28	БСТ-Банк	2883	Кемеровская обл.	1909824	1637736	272088	16.61
606	-2	Газнефтьбанк	3223	Саратовская обл.	1879877	1887479	-7602	-0.4
607	77	Максима	3379	Москва и обл.	1861721	1296001	565720	43.65
608	17	Московский Вексельный Банк	2697	Москва и обл.	1861205	1718947	142258	8.28
609	-16	Приско Капитал Банк	2537	Москва и обл.	1859897	1972024	-112127	-5.69
610	84	Сибэс	208	Омская обл.	1828004	1248201	579803	46.45
611	17	Национальный Банк Взаимного Кредита	3214	Москва и обл.	1814504	1660461	154043	9.28
612	-27	Михайловский ПЖСБ	2961	Волгоградская обл.	1807186	2044374	-237188	-11.6
613	-11	Старооскольский Агропромбанк	1050	Белгородская обл.	1797925	1892677	-94752	-5.01
614	-22	Вэлтон Банк	1105	Белгородская обл.	1797298	2000361	-203063	-10.15
615	2	Российский Национальный Коммерческий Банк	1354	Москва и обл.	1790545	1773061	17484	0.99
616	-70	Промышленно-Финансовое Сотрудничество	2410	Москва и обл.	1772270	2336645	-564375	-24.15
617	-146	Интеркапитал-Банк	2706	Мордовия	1771400	3243814	-1472414	-45.39
618	-91	Совинком	2302	Москва и обл.	1769374	2560572	-791198	-30.9
619	-46	Тагилбанк	1635	Свердловская обл.	1750644	2152210	-401566	-18.66
620	-6	Единственный	3187	Москва и обл.	1748046	1790806	-42760	-2.39
621	233	Ростфинанс	481	Ростовская обл.	1741583	466554	1275029	273.29
622	-1	Торжокуниверсалбанк	933	Тверская обл.	1736846	1747051	-10205	-0.58
623	-1	Бумеранг	1002	Вологодская обл.	1736836	1746275	-9439	-0.54
624	-16	Рапида	3371	Москва и обл.	1714407	1837046	-122639	-6.68
625	48	Екатерининский	2167	Москва и обл.	1707209	1356790	350419	25.83
626	-72	Эсидбанк	1991	Дагестан	1692118	2273876	-581758	-25.58
627	34	Далена	1948	Москва и обл.	1680089	1445680	234409	16.21
628	69	Геленджик-Банк	790	Краснодарский край	1670091	1231922	438169	35.57
629	-18	Соколовский	2830	Москва и обл.	1666741	1807185	-140444	-7.77
630	280	Единый Строительный Банк	3506	Омская обл.	1665497	202853	1462644	721.04
631	65	Санкт-Петербургский Банк Инвестиций	3468	Санкт-Петербург и обл.	1658013	1237402	420611	33.99
632	-2	Кемсоцинбанк	96	Кемеровская обл.	1629435	1649242	-19807	-1.2
633	24	Московско-Парижский Банк	2646	Москва и обл.	1615506	1457617	157889	10.83
634	-121	Уралприватбанк	153	Свердловская обл.	1612529	2718771	-1106242	-40.69
635	60	Глобус	2438	Москва и обл.	1604549	1244741	359808	28.91
636	31	Смолевич	1121	Смоленская обл.	1600454	1401289	199165	14.21
637	17	Русский Элитарный Банк	3231	Москва и обл.	1599022	1470002	129020	8.78
638	-69	Сталь Банк	2248	Москва и обл.	1591034	2174517	-583483	-26.83
639	87	Почтобанк	1788	Пермская обл.	1577395	1039973	537422	51.68
640	69	Кетовский Коммерческий Банк	842	Курганская обл.	1575024	1176413	398611	33.88
641	44	Калуга	1151	Калужская обл.	1552639	1293308	259331	20.05
642	57	Акцент	696	Оренбургская обл.	1541550	1222381	319169	26.11
643	-28	Арт-Банк	2779	Северная Осетия — Алания	1539189	1787540	-248351	-13.89
644	6	Межрегиональный Клиринговый Банк	2543	Москва и обл.	1535679	1488158	47521	3.19
645	-11	БВА Банк	1684	Москва и обл.	1524707	1633577	-108870	-6.66
646	42	Майкопбанк	1136	Адыгея	1521128	1280057	241071	18.83
647	-4	Златкомбанк	568	Москва и обл.	1518276	1586332	-68056	-4.29
648	26	Гринкомбанк	1184	Иркутская обл.	1514183	1350565	163618	12.11
649	33	Азимут	3154	Москва и обл.	1514125	1305024	209101	16.02
650	8	Примтеркомбанк	21	Приморский край	1509094	1456180	52914	3.63
651	13	Жилкредит	1736	Москва и обл.	1502632	1431141	71491	5
652	-16	Новый Кредитный Союз	3139	Москва и обл.	1492251	1622302	-130051	-8.02
653	178	Кредпромбанк	1165	Ярославская обл.	1488873	550530	938343	170.44
654	-31	Сервис-Резерв	2034	Москва и обл.	1487176	1721551	-234375	-13.61
655	-4	Саратов	330	Саратовская обл.	1478192	1479708	-1516	-0.1
656	-27	Тайм Банк	3120	Москва и обл.	1477274	1652078	-174804	-10.58
657	153	Европейский Экспресс	3449	Москва и обл.	1466577	639158	827419	129.45
658	-13	Академический Русский Банк	622	Москва и обл.	1463799	1554833	-91034	-5.85
659	52	Метрополь	1639	Москва и обл.	1461216	1171604	289612	24.72
660	-94	Кредитинвест	1197	Дагестан	1454289	2186591	-732302	-33.49
661	2	Республиканский Кредитный Альянс	3017	Москва и обл.	1445887	1436070	9817	0.68
662	-72	Рублевский	2192	Москва и обл.	1439095	2013314	-574219	-28.52
663	17	КИП-Банк	2843	Москва и обл.	1427002	1313718	113284	8.62
664	61	Первый Клиентский Банк	3436	Москва и обл.	1421818	1057492	364326	34.45
665	-16	Народный Банк	2249	Карачаево-Черкесия	1413262	1506944	-93682	-6.22
666	118	Строительно-Коммерческий Банк	3050	Архангельская обл.	1406616	752293	654323	86.98
667	-40	Алтынбанк	2070	Татарстан	1404206	1698324	-294118	-17.32
668	35	Мосводоканалбанк	2863	Москва и обл.	1403003	1198166	204837	17.1
669	-21	Радиан	1675	Иркутская обл.	1385615	1519272	-133657	-8.8
670	-11	Великие Луки Банк	598	Псковская обл.	1375762	1453285	-77523	-5.33
671	-9	Уралфинанс	1370	Свердловская обл.	1360048	1444806	-84758	-5.87
672		Яндекс.Деньги	3510	Россия	1359201			
673	-63	Руна-Банк	3207	Москва и обл.	1359113	1815448	-456335	-25.14
674	1	Вологдабанк	992	Вологодская обл.	1357533	1338654	18879	1.41
675	-258	Расчетная Палата РТС	3335	Москва и обл.	1355955	4485267	-3129312	-69.77
676	22	ИстКом-Финанс	3435	Москва и обл.	1340139	1231352	108787	8.83
677	52	Региональный Коммерческий Банк	836	Ульяновская обл.	1336684	1032103	304581	29.51
678	85	Динамичные Системы	3439	Москва и обл.	1329212	861438	467774	54.3
679	48	Курган	2568	Курганская обл.	1328790	1039184	289606	27.87
680	21	Тексбанк	2756	Карачаево-Черкесия	1328262	1215771	112491	9.25
681	69	Арзамас	1281	Нижегородская обл.	1307388	926699	380689	41.08
682	-27	Нерюнгрибанк	825	Саха (Якутия)	1307343	1468408	-161065	-10.97
683	-2	Булгар Банк	1917	Татарстан	1306158	1313312	-7154	-0.54
684	26	Симбирск	653	Ульяновская обл.	1295109	1175725	119384	10.15
685	-17	Тандем	1951	Москва и обл.	1285819	1398687	-112868	-8.07
686	134	Азия Банк	3183	Москва и обл.	1285047	582593	702454	120.57
687	-10	Объединенный Банк Республики	1016	Чувашия	1280202	1338018	-57816	-4.32
688	36	Первый Дортрансбанк	3271	Кировская обл.	1276009	1061289	214720	20.23
689	-6	Спутник	1071	Оренбургская обл.	1267906	1304632	-36726	-2.82
690	-49	Новый Промышленный Банк	930	Москва и обл.	1260204	1593318	-333114	-20.91
691	-5	Саммит Банк	85	Приморский край	1257415	1289110	-31695	-2.46
692	-32	Ганзакомбанк	1734	Санкт-Петербург и обл.	1240005	1448971	-208966	-14.42
693	162	Еврокапитал-Альянс	3459	Ярославская обл.	1239379	464157	775222	167.02
694	20	Капиталбанк	2547	Ростовская обл.	1224916	1130429	94487	8.36
695	5	Онего	2484	Карелия	1219846	1220583	-737	-0.06
696	-6	Приполярком	507	Тюменская обл.	1217981	1259493	-41512	-3.3
697	22	Синергия	2884	Саратовская обл.	1215514	1079881	135633	12.56
698	58	Местный Кредит	3370	Москва и обл.	1210475	903722	306753	33.94
699	3	Расчетный Дом	3350	Москва и обл.	1203736	1200047	3689	0.31
700	8	Дон-Тексбанк	1818	Ростовская обл.	1182769	1177926	4843	0.41
701	3	Севзапинвестпромбанк	2152	Санкт-Петербург и обл.	1176569	1196790	-20221	-1.69
702	-37	Бизнес для Бизнеса	1060	Чувашия	1176310	1407757	-231447	-16.44
703	43	Жилстройбанк	2769	Москва и обл.	1165403	940528	224875	23.91
704	49	Агроинкомбанк	1946	Астраханская обл.	1158288	921359	236929	25.72
705	-26	Си Ди Би Банк	3339	Краснодарский край	1150481	1322664	-172183	-13.02
706	-17	Флора-Москва	533	Москва и обл.	1148253	1267815	-119562	-9.43
707	37	Кредитбанк	1035	Калмыкия	1144510	947404	197106	20.8
708	-39	Акрополь	3027	Москва и обл.	1143575	1397868	-254293	-18.19
709	32	Америкэн Экспресс Банк	3460	Москва и обл.	1138181	953814	184367	19.33
710	138	Евросиб Банк	594	Псковская обл.	1136311	491467	644844	131.21
711	107	Кубаньторгбанк	478	Краснодарский край	1113685	591220	522465	88.37
712	21	Химик	1114	Нижегородская обл.	1108694	1015926	92768	9.13
713	-78	Металлург	2877	Москва и обл.	1090259	1633356	-543097	-33.25
714	24	Международный Строительный Банк	3484	Москва и обл.	1083336	966839	116497	12.05
715	2	Регионфинансбанк	3357	Москва и обл.	1081093	1096712	-15619	-1.42
716	41	Евроазиатский Инвестиционный Банк	2897	Москва и обл.	1071528	894178	177350	19.83
717	-45	Ноосфера	2650	Республика Алтай	1068624	1362404	-293780	-21.56
718	10	Сельмашбанк	106	Ростовская обл.	1062940	1036817	26123	2.52
719	-6	Северинвестбанк	2264	Белгородская обл.	1032164	1154452	-122288	-10.59
720	15	Турбобанк	3203	Санкт-Петербург и обл.	1028017	995681	32336	3.25
721	91	Ипозембанк	3026	Самарская обл.	1027571	636454	391117	61.45
722	12	ЕАТП Банк	1765	Астраханская обл.	1021534	1008156	13378	1.33
723	25	Взаимодействие	1704	Новосибирская обл.	1016096	935703	80393	8.59
724	18	Финарс Банк	2938	Москва и обл.	1015454	951565	63889	6.71
725	46	Инвест-Экобанк	1956	Санкт-Петербург и обл.	1014235	840065	174170	20.73
726	-79	Новый Век	3417	Москва и обл.	1013609	1534108	-520499	-33.93
727	-15	Содружество	2923	Москва и обл.	1007058	1167700	-160642	-13.76
728	3	Мурманский Социальный Коммерческий Банк	2722	Мурманская обл.	1000352	1020037	-19685	-1.93
729	-7	Центрально-Азиатский	3037	Хакасия	999038	1067529	-68491	-6.42
730	63	НоваховКапиталБанк	635	Москва и обл.	989112	714850	274262	38.37
731	44	Мико-Банк	3195	Москва и обл.	979028	786444	192584	24.49
732	46	Камский Горизонт	2554	Татарстан	976059	778359	197700	25.4
733	19	Тетраполис	1586	Санкт-Петербург и обл.	974467	922189	52278	5.67
734	32	Прайм Финанс	2758	Санкт-Петербург и обл.	971524	847681	123843	14.61
735	5	Московский Клиринговый Центр	3314	Москва и обл.	970622	961832	8790	0.91
736	31	Бузулукбанк	1282	Оренбургская обл.	958971	846868	112103	13.24
737	-14	Байкалкредобанк	2990	Иркутская обл.	946468	1064772	-118304	-11.11
738	-1	Атлас Банк	3477	Москва и обл.	945307	976145	-30838	-3.16
739	-9	Миръ	3089	Москва и обл.	943772	1029538	-85766	-8.33
740	40	Московский Национальный Инвестиционный Банк	3181	Москва и обл.	934698	773140	161558	20.9
741	14	Месед	184	Дагестан	922162	907907	14255	1.57
742	40	Плато-Банк	2071	Свердловская обл.	919333	766876	152457	19.88
743	25	Арсенал	3000	Москва и обл.	907153	846809	60344	7.13
744	1	Первоуральскбанк	965	Свердловская обл.	903980	945003	-41023	-4.34
745	-185	Международный Расчетный Банк	3028	Москва и обл.	902036	2246312	-1344276	-59.84
746	3	Вакобанк	1291	Псковская обл.	898566	930990	-32424	-3.48
747	12	МТИ-Банк	1052	Москва и обл.	897017	887556	9461	1.07
748	56	Линк-Банк	2699	Москва и обл.	892582	670011	222571	33.22
749	120	1Банк	2896	Северная Осетия — Алания	885561	414343	471218	113.73
750	-29	Региональный Банк Сбережений	3367	Москва и обл.	878156	1067795	-189639	-17.76
751	45	Кузбассхимбанк	2868	Кемеровская обл.	877743	709962	167781	23.63
752	-9	Спецстройбанк	236	Москва и обл.	875971	951377	-75406	-7.93
753	30	Акция	927	Ивановская обл.	865593	761914	103679	13.61
754	44	Платежный Сервисный Банк	1943	Башкортостан	862273	702126	160147	22.81
755	18	Региональный Корпоративный Банк	1134	Москва и обл.	833782	825890	7892	0.96
756	20	Прохладный	874	Кабардино-Балкария	830087	783001	47086	6.01
757	79	Москва	1661	Москва и обл.	829353	535056	294297	55
758	27	Классик Эконом Банк	3298	Северная Осетия — Алания	815687	746658	69029	9.25
759	62	Алданзолотобанк	854	Саха (Якутия)	804056	582540	221516	38.03
760	47	Промсвязьинвест	2761	Дагестан	798451	662693	135758	20.49
761	16	Прокоммерцбанк	2996	Москва и обл.	792601	778854	13747	1.77
762	27	Славянбанк	804	Новгородская обл.	789465	728697	60768	8.34
763	50	НСТ-Банк	1738	Оренбургская обл.	782666	636080	146586	23.05
764	-4	Русский Банк Сбережений	779	Ставропольский край	778766	884774	-106008	-11.98
765	9	РусьРегионБанк	685	Москва и обл.	759405	793374	-33969	-4.28
766	-95	Идеалбанк	3491	Москва и обл.	752872	1366945	-614073	-44.92
767	63	СМБ-Банк	3504	Санкт-Петербург и обл.	749915	555427	194488	35.02
768	35	Невастройинвест	1926	Санкт-Петербург и обл.	747488	670238	77250	11.53
769	1	Сургутский Центральный Коммерческий Банк	684	Тюменская обл.	747005	840590	-93585	-11.13
770	-1	ЮМК	3495	Краснодарский край	746862	845509	-98647	-11.67
771	26	Космос	2245	Москва и обл.	741997	702606	39391	5.61
772	27	Центр Межбанковских Расчетов	3400	Москва и обл.	736658	691981	44677	6.46
773	-34	Межрегионбанк	1059	Москва и обл.	725799	962454	-236655	-24.59
774	16	Банк Премьер Кредит	1663	Москва и обл.	720006	725890	-5884	-0.81
775	-39	Анелик РУ	3443	Москва и обл.	713806	984017	-270211	-27.46
776	110	Джаст Банк	3503	Москва и обл.	712326	322667	389659	120.76
777	-5	Аделантбанк	1835	Москва и обл.	711876	839910	-128034	-15.24
778	-20	Трастовый Республиканский Банк	3404	Москва и обл.	709908	889328	-179420	-20.17
779	23	Банк Развития Бизнеса	1910	Кемеровская обл.	695362	673743	21619	3.21
780	35	Банк ВВБ	1093	Ярославская обл.	694770	599460	95310	15.9
781	19	Ресурс-Траст	3122	Москва и обл.	678533	690773	-12240	-1.77
782	83	Русский Финансовый Альянс	2035	Москва и обл.	678487	427916	250571	58.56
783	33	Майский	1673	Кабардино-Балкария	674598	598348	76250	12.74
784	-66	Адам Интернэшнл	2232	Дагестан	672091	1096374	-424283	-38.7
785	-70	Рингкомбанк	1909	Ингушетия	669090	1122904	-453814	-40.41
786	70	Вятич	2796	Рязанская обл.	659905	462479	197426	42.69
787	90	Народный Инвестиционный Банк	2876	Самарская обл.	655102	370236	284866	76.94
788	46	Стандарт-Кредит	841	Адыгея	655060	543770	111290	20.47
789	-111	Кредитимпэкс Банк	2037	Москва и обл.	649676	1331180	-681504	-51.2
790	-4	Башпромбанк	1006	Башкортостан	649593	743703	-94110	-12.65
791	18	Эко-Инвест	3116	Москва и обл.	641269	647046	-5777	-0.89
792	114	Фреско Банк	1415	Москва и обл.	640909	223005	417904	187.4
793	48	РУБанк	2813	Ростовская обл.	628372	518869	109503	21.1
794	-15	Балаково-Банк	444	Саратовская обл.	626957	775428	-148471	-19.15
795	67	Природа	3399	Москва и обл.	625435	438530	186905	42.62
796	-45	Геобанк	2027	Москва и обл.	625314	924536	-299222	-32.36
797	110	Первый Депозитный Банк	1244	Москва и обл.	622440	217937	404503	185.61
798	-51	Тульский Расчетный Центр	3380	Тульская обл.	618451	940383	-321932	-34.23
799	30	Тальменка-Банк	826	Алтайский край	610418	557547	52871	9.48
800	22	Гефест	1046	Тверская обл.	609260	581138	28122	4.84
801	-40	ОЛМА-Банк	3250	Москва и обл.	604387	880828	-276441	-31.38
802	-132	Восточно-Европейский Трастовый Банк	2253	Москва и обл.	596582	1380038	-783456	-56.77
803	-12	Народный Земельно-Промышленный Банк	2873	Алтайский край	589183	723348	-134165	-18.55
804	34	Ауэрбанк	3105	Москва и обл.	587726	530400	57326	10.81
805	34	Стар Альянс	3433	Москва и обл.	587130	527234	59896	11.36
806	37	Внешфинбанк	3173	Краснодарский край	576146	502085	74061	14.75
807	67	Рента-Банк	3095	Москва и обл.	568529	380200	188329	49.53
808	-54	Аскания Траст	286	Москва и обл.	567256	910575	-343319	-37.7
809	28	Старый Кремль	2657	Москва и обл.	567090	532532	34558	6.49
810	-16	Лада-Кредит	2668	Москва и обл.	566756	714529	-147773	-20.68
811	-46	Арксбанк	1868	Воронежская обл.	566591	855462	-288871	-33.77
812	72	Мигом	3323	Москва и обл.	564373	340776	223597	65.61
813	20	Банк РСИ	3415	Москва и обл.	564358	543943	20415	3.75
814	-13	Холдинвестбанк	2837	Москва и обл.	562143	679178	-117035	-17.23
815	11	Имбанк	2098	Дагестан	558912	564496	-5584	-0.99
816	-197	Новокиб	1747	Кемеровская обл.	553287	1763777	-1210490	-68.63
817	58	Межрегиональный Банк Реконструкции	2620	Москва и обл.	550918	374465	176453	47.12
818	-23	Лидер	3304	Москва и обл.	547486	711193	-163707	-23.02
819	5	Центрально-Европейский Банк	2670	Москва и обл.	539544	564881	-25337	-4.49
820	62	ГРиС-Банк	1928	Ставропольский край	523952	351887	172065	48.9
821	49	ВРБ Москва	3499	Москва и обл.	521755	409841	111914	27.31
822	-41	Кутузовский	3190	Москва и обл.	519834	767055	-247221	-32.23
823	56	ПрестижКредитБанк	2922	Дагестан	506388	360253	146135	40.56
824	59	АвтоКредитБанк	1973	Татарстан	503538	349097	154441	44.24
825	2	Европейский Стандарт	3200	Кабардино-Балкария	494084	561442	-67358	-12
826	-21	Народный Банк Республики Тыва	1309	Тыва	488509	668810	-180301	-26.96
827	25	Дружба	990	Тюменская обл.	482139	478289	3850	0.8
828	16	Северная Клиринговая Палата	3317	Архангельская обл.	481687	500856	-19169	-3.83
829	-10	Объединенный Национальный Банк	2074	Нижегородская обл.	477430	583906	-106476	-18.24
830	-2	АББ	2937	Москва и обл.	472605	557772	-85167	-15.27
831	-6	Далта-Банк	142	Приморский край	470775	564545	-93770	-16.61
832	21	НКБ	2942	Калмыкия	467447	476508	-9061	-1.9
833	-16	Новый Коммерческий Банк	347	Дагестан	466826	593112	-126286	-21.29
834	37	АлтайБизнес-Банк	2388	Алтайский край	464556	408086	56470	13.84
835	5	Надежность	2425	Курганская обл.	463574	524517	-60943	-11.62
836	-1	Энтузиастбанк	3048	Москва и обл.	461007	537901	-76894	-14.3
837	20	Соверен Банк	3206	Москва и обл.	455880	460249	-4369	-0.95
838	50	Таганрогбанк	3136	Ростовская обл.	448748	318383	130365	40.95
839	63	Берейт	3505	Санкт-Петербург и обл.	445074	231935	213139	91.9
840	6	Иронбанк	1724	Москва и обл.	442129	497480	-55351	-11.13
841	23	Южный Региональный Банк	3015	Ростовская обл.	430843	431913	-1070	-0.25
842	3	МВС Банк	2407	Дагестан	429155	497694	-68539	-13.77
843	16	Еврокапитал-Альянс	2672	Дагестан	424608	446389	-21781	-4.88
844	23	Максимум	466	Ростовская обл.	417218	422647	-5429	-1.28
845	68	Бринкс	3486	Москва и обл.	412988	153167	259821	169.63
846	12	РИТЦ Банк	2677	Москва и обл.	411436	457695	-46259	-10.11
847	0	Алжан	2491	Дагестан	403727	495734	-92007	-18.56
848	12	Далетбанк	3049	Москва и обл.	402242	442479	-40237	-9.09
849	44	Информпрогресс	2166	Москва и обл.	401555	287843	113712	39.5
850	22	Логос	3233	Москва и обл.	396538	400257	-3719	-0.93
851	22	Вестинтербанк	3398	Москва и обл.	387127	399589	-12462	-3.12
852	33	Альтернатива	3452	Москва и обл.	370352	325978	44374	13.61
853	39	Расчетная Палата СВМБ	3324	Самарская обл.	366563	295821	70742	23.91
854	33	Эно	1988	Дагестан	352668	319867	32801	10.25
855	11	Континенталь	3184	Ставропольский край	351630	427819	-76189	-17.81
856	-69	Дагестан	543	Дагестан	351100	742588	-391488	-52.72
857	-25	Кредо Финанс	793	Дагестан	350824	545986	-195162	-35.74
858	-7	Сунжа	2023	Ингушетия	346662	478375	-131713	-27.53
859	-53	Конгресс-Банк	2330	Москва и обл.	339290	664046	-324756	-48.91
860	16	Российская Финансовая Корпорация	3099	Москва и обл.	334872	371644	-36772	-9.89
861	35	Онлайн Банк	2462	Москва и обл.	321793	279210	42583	15.25
862	28	Дорис Банк	1679	Москва и обл.	318825	310844	7981	2.57
864	31	Терра	3476	Москва и обл.	297295	286209	11086	3.87
865	15	Сетевая Расчетная Палата	3332	Татарстан	296419	356732	-60313	-16.91
866	42	ФФИН Банк (бывш. Охабанк)	1143	Сахалинская обл.	288980	213811	75169	35.16
867	33	Лэнд-Банк	1478	Москва и обл.	286466	240312	46154	19.21
868	23	Регнум	3373	Москва и обл.	284317	300558	-16241	-5.4
869	-55	Каспий	639	Дагестан	277811	630038	-352227	-55.91
870	47	Расчетный Банковский Центр	3487	Москва и обл.	277650	121936	155714	127.7
871	26	Континент Финанс	149	Калужская обл.	274586	271566	3020	1.11
872	37	Петербургский Расчетный Центр	3306	Санкт-Петербург и обл.	270280	210295	59985	28.52
873	8	ТЭСТ	3440	Москва и обл.	240106	353661	-113555	-32.11
874	27	Тайдон	2085	Кемеровская обл.	238704	235127	3577	1.52
875	30	Рунэтбанк	2829	Москва и обл.	221998	224079	-2081	-0.93
876	28	Майма	1037	Республика Алтай	211610	227958	-16348	-7.17
877	-16	K2 Банк	2851	Дагестан	202794	442181	-239387	-54.14
878		Северстройбанк	3507	Вологодская обл.	195846			
879	37	Евроинвест	3383	Москва и обл.	193676	127680	65996	51.69
880	19	Красноярский Краевой Расчетный Центр	3483	Красноярский край	180721	246255	-65534	-26.61
881	30	КредитАльянс	3472	Вологодская обл.	166859	179386	-12527	-6.98
882	42	Платежный Клиринговый Дом	3343	Москва и обл.	145160	93255	51905	55.66
883	35	Фидбэк	3502	Москва и обл.	143837	116712	27125	23.24
884	-35	Банковские Информационные Технологии	3318	Тульская обл.	133147	488790	-355643	-72.76
885	9	Русское Финансовое Общество	3427	Москва и обл.	118189	287257	-169068	-58.86
886		Монета.ру	3508	Марий Эл	117968			
887	32	Зеленокумская	1239	Ставропольский край	117619	114720	2899	2.53
888	24	Финансовые Услуги	3496	Москва и обл.	115297	162122	-46825	-28.88
889	40	РИБ	2749	Москва и обл.	112849	62960	49889	79.24
890	24	Интеррасчет	1618	Карачаево-Черкесия	96225	147116	-50891	-34.59
891	7	Уральская Расчетная Палата	3326	Москва и обл.	86651	256508	-169857	-66.22
892	23	Умут	2435	Дагестан	85977	139590	-53613	-38.41
893		Деньги.Мэйл.Ру	3511	Москва и обл.	82417			
894	29	Вест	2605	Москва и обл.	72740	97059	-24319	-25.06
895	-131	ЭнергоБизнес	3485	Москва и обл.	66445	857638	-791193	-92.25
896	25	Сергиево-Посадская Расчетная Палата	384	Москва и обл.	49326	102525	-53199	-51.89
897	35	Сибирский Расчетный Центр	3308	Новосибирская обл.	47405	35070	12335	35.17
898	28	Межрегиональный центр микрокредитования	3489	Воронежская обл.	42624	69713	-27089	-38.86
899	29	Инновационный Расчетный Центр	3447	Москва и обл.	40300	67087	-26787	-39.93
900	33	Частный Расчетно-Кассовый Центр	3420	Москва и обл.	38723	25768	12955	50.28
901	30	Первый Земельный Расчетный Центр	3381	Курская обл.	37478	38632	-1154	-2.99
902	20	Международная Уральская Расчетная Палата	3322	Москва и обл.	34301	99918	-65617	-65.67
903	27	Транзит	2688	Дагестан	31078	39282	-8204	-20.88
904	16	Национальная Расчетная Компания	3386	Москва и обл.	27085	107291	-80206	-74.76
905	30	Финансово-Расчетный Центр	3319	Астраханская обл.	25239	21704	3535	16.29
906	28	Тор Кредит	3497	Москва и обл.	24315	24049	266	1.11
907	30	Ассигнация	865	Ставропольский край	10165	5652	4513	79.85
908	30	Клиринговый Дом	3430	Санкт-Петербург и обл.	4284	4125	159	3.85
909	30	АРБ-Инкасс	3353	Москва и обл.	2581	2969	-388	-13.07
