Позиция в рейтинге	Изменение позиции в рейтинге	Название банка	Номер лицензии	Регион регистрации	Декабрь, 2015, тыс. рублей	Январь, 2015, тыс. рублей	Изменение, тыс. рублей	Изменение, %
12	3	Московский Кредитный Банк	1978	Москва и обл.	1113736506	597479579	516256927	86.41
6	2	Россельхозбанк	3349	Москва и обл.	2551779006	2165034716	386744290	17.86
2	0	ВТБ	1000	Санкт-Петербург и обл.	8742464567	8363248420	379216147	4.53
15	5	Бинбанк	2562	Москва и обл.	756341388	413254302	343087086	83.02
19	21	Совкомбанк	963	Костромская обл.	491838800	217343800	274495000	126.3
3	0	Газпромбанк	354	Москва и обл.	4984239100	4722887700	261351400	5.53
25	29	Рост Банк	2888	Москва и обл.	383248497	146418141	236830356	161.75
21	11	Московский Областной Банк	1751	Москва и обл.	464808093	290594433	174213660	59.95
32	18	Югра	880	Ханты-Мансийский АО — Югра	327614178	167762133	159852045	95.28
11	0	Промсвязьбанк	3251	Москва и обл.	1221401758	1088395533	133006225	12.22
1	0	Сбербанк России	1481	Москва и обл.	22433146804	22330238836	102907968	0.46
29	6	Уральский Банк Реконструкции и Развития	429	Свердловская обл.	346364159	247993587	98370572	39.67
35	9	Всероссийский Банк Развития Регионов	3287	Москва и обл.	276530892	193237568	83293324	43.1
24	5	ИНГ Банк	2495	Москва и обл.	402937298	321054315	81882983	25.5
5	0	ФК Открытие	2209	Москва и обл.	2813360795	2735566373	77794422	2.84
59	47	Экспресс-Волга	3085	Саратовская обл.	127934576	52019119	75915457	145.94
46	21	Пересвет	2110	Москва и обл.	173689535	119174140	54515395	45.74
41	5	Транскапиталбанк (ТКБ)	2210	Москва и обл.	223926661	176997963	46928698	26.51
60	23	Сургутнефтегазбанк	588	Ханты-Мансийский АО — Югра	124621375	78825168	45796207	58.1
37	2	Внешпромбанк	3261	Москва и обл.	274902436	230796330	44106106	19.11
16	1	Россия	328	Санкт-Петербург и обл.	558480227	514792432	43687795	8.49
79	31	Таврический	2304	Санкт-Петербург и обл.	79711638	47457028	32254610	67.97
45	3	Татфондбанк	3058	Татарстан	201896350	171335417	30560933	17.84
92	56	Российский Национальный Коммерческий Банк	1354	Симферополь	59657999	29835024	29822975	99.96
39	-1	Абсолют Банк	2306	Москва и обл.	263012461	234462233	28550228	12.18
36	0	Новикомбанк	2546	Москва и обл.	275293911	246751736	28542175	11.57
44	1	Российский Капитал	2312	Москва и обл.	216520126	188601749	27918377	14.8
20	-2	Ак Барс	2590	Татарстан	488877251	462615334	26261917	5.68
114	83	Росэксимбанк	2790	Москва и обл.	43347831	17701621	25646210	144.88
76	13	РосинтерБанк	226	Москва и обл.	88805929	64945479	23860450	36.74
109	61	Газэнергобанк	3252	Калужская обл.	45422607	23119861	22302746	96.47
68	14	Интеркоммерц Банк	1657	Москва и обл.	101183817	78948196	22235621	28.16
81	26	Военно-Промышленный Банк	3065	Москва и обл.	73672261	51844344	21827917	42.1
80	23	Банк Финсервис	3388	Москва и обл.	75121926	53639456	21482470	40.05
51	8	ДельтаКредит	3338	Москва и обл.	154603293	133554724	21048569	15.76
149	156	Инвестиционный Республиканский Банк	2571	Москва и обл.	27502928	7991807	19511121	244.14
107	47	БКС — Инвестиционный Банк	101	Новосибирская обл.	46704165	27360758	19343407	70.7
23	1	Ситибанк	2557	Москва и обл.	419809025	400472851	19336174	4.83
78	13	Бинбанк кредитные карты	2827	Москва и обл.	81251914	63150171	18101743	28.66
96	36	Бэнк оф Чайна	2309	Москва и обл.	55508094	38191401	17316693	45.34
93	28	Образование	1521	Москва и обл.	59496856	42567119	16929737	39.77
83	17	Лето Банк	650	Москва и обл.	72211281	56341040	15870241	28.17
57	8	Росгосстрах Банк	3073	Москва и обл.	139433405	124029541	15403864	12.42
53	4	МСП Банк	3340	Москва и обл.	151174289	135972897	15201392	11.18
70	10	Креди Агриколь КИБ	1680	Санкт-Петербург и обл.	99069353	84070936	14998417	17.84
151	93	Ишбанк	2867	Москва и обл.	27148006	12637468	14510538	114.82
91	23	Аверс	415	Татарстан	61242389	47035918	14206471	30.2
86	18	БФГ-Кредит	3068	Москва и обл.	65593923	53302572	12291351	23.06
89	16	Экспобанк	2998	Москва и обл.	64225502	52685924	11539578	21.9
55	1	Тинькофф Банк	2673	Москва и обл.	147558418	136156886	11401532	8.37
58	4	Авангард	2879	Москва и обл.	138309498	126985538	11323960	8.92
54	1	Азиатско-Тихоокеанский Банк	1810	Амурская обл.	149712338	138656893	11055445	7.97
152	65	Плюс Банк	1189	Москва и обл.	26650277	16001555	10648722	66.55
131	43	Держава	2738	Москва и обл.	32075114	21812585	10262529	47.05
102	29	РН Банк	170	Москва и обл.	48401349	38387567	10013782	26.09
69	9	БНП Париба Банк	3407	Москва и обл.	101157539	91687127	9470412	10.33
73	8	Локо-Банк	2707	Москва и обл.	92227894	83070460	9157434	11.02
148	42	Объединенный Капитал	2611	Санкт-Петербург и обл.	27721751	19190639	8531112	44.45
213	157	Российская Финансовая Корпорация	3099	Москва и обл.	14035227	5534004	8501223	153.62
235	246	Арксбанк	1868	Москва и обл.	11134937	2979978	8154959	273.66
63	10	Международный Финансовый Клуб	2618	Москва и обл.	109054367	100942138	8112229	8.04
196	99	Джей энд Ти Банк	3061	Москва и обл.	16386128	8490711	7895417	92.99
90	12	Кубань Кредит	2518	Краснодарский край	63121464	55414165	7707299	13.91
85	9	АйСиБиСи Банк	3475	Москва и обл.	67242735	59660851	7581884	12.71
95	13	Росэнергобанк	2211	Москва и обл.	55509246	48247906	7261340	15.05
146	34	Московское Ипотечное Агентство	3344	Москва и обл.	28376576	21231951	7144625	33.65
144	32	Солидарность (Самара)	554	Самарская обл.	28750476	21659802	7090674	32.74
113	23	Интерпрогрессбанк	600	Москва и обл.	43524275	36852141	6672134	18.11
164	35	Генбанк	2490	Москва и обл.	24047811	17423789	6624022	38.02
168	50	СтарБанк	548	Москва и обл.	22542033	15998178	6543855	40.9
181	56	Социнвестбанк	1132	Башкортостан	19551838	13200520	6351318	48.11
177	49	Башкомснаббанк	1398	Башкортостан	20586166	14337905	6248261	43.58
145	27	АйМаниБанк	1975	Москва и обл.	28490801	22393617	6097184	27.23
172	47	СЭБ Банк	3235	Санкт-Петербург и обл.	21844262	15762075	6082187	38.59
211	82	Татсоцбанк	480	Татарстан	14567837	8529514	6038323	70.79
138	27	Тольяттихимбанк	2507	Самарская обл.	30315516	24323488	5992028	24.63
243	140	Кошелев-Банк	3300	Самарская обл.	10656937	5106435	5550502	108.7
143	24	ОФК Банк	2270	Москва и обл.	29048175	23579662	5468513	23.19
150	23	Девон-Кредит	1972	Татарстан	27387771	21944164	5443607	24.81
224	102	Объединенный Кредитный Банк	1118	Ярославская обл.	12365067	7019893	5345174	76.14
183	44	ВУЗ-Банк	1557	Свердловская обл.	19393559	14168418	5225141	36.88
62	6	СКБ-Банк	705	Свердловская обл.	123055317	118154212	4901105	4.15
162	26	Чайна Констракшн	3515	Москва и обл.	24386473	19616997	4769476	24.31
110	15	Сумитомо Мицуи	3494	Москва и обл.	45383679	40842960	4540719	11.12
217	63	Финансовый Стандарт	1053	Москва и обл.	13456822	8998746	4458076	49.54
139	23	Мерседес-Бенц Банк Рус	3473	Москва и обл.	29727447	25367412	4360035	17.19
119	20	Первый Чешско-Российский Банк	3291	Москва и обл.	39671737	35346026	4325711	12.24
194	45	Данске Банк	3307	Санкт-Петербург и обл.	17016420	12885203	4131217	32.06
112	14	ББР Банк	2929	Москва и обл.	44244585	40137401	4107184	10.23
120	18	Левобережный	1343	Новосибирская обл.	39463214	35437364	4025850	11.36
219	60	Агросоюз	1459	Москва и обл.	12992660	9030771	3961889	43.87
258	117	Финанс Бизнес Банк	520	Москва и обл.	9193031	5309518	3883513	73.14
100	15	Межтопэнергобанк	2956	Москва и обл.	49962227	46123281	3838946	8.32
115	14	Примсоцбанк	2733	Приморский край	42378648	38651274	3727374	9.64
42	-1	Московский Индустриальный Банк	912	Москва и обл.	219298948	215586928	3712020	1.72
232	78	Ренессанс	1939	Москва и обл.	11346975	7662423	3684552	48.09
195	46	Ури Банк	3479	Москва и обл.	16495687	12838516	3657171	28.49
159	20	Легион	3117	Москва и обл.	25019364	21371668	3647696	17.07
137	19	Кредит Урал Банк	2584	Челябинская обл.	30445313	26823786	3621527	13.5
117	17	Челябинвестбанк	493	Челябинская обл.	41523327	38008742	3514585	9.25
133	18	Кедр	1574	Красноярский край	31547376	28070661	3476715	12.39
197	41	Центркомбанк	2983	Москва и обл.	16315400	13074381	3241019	24.79
231	70	Русский Торговый Банк	2842	Москва и обл.	11406349	8202635	3203714	39.06
322	156	Енисей	474	Красноярский край	6163263	3013522	3149741	104.52
180	25	Морган Стэнли Банк	3456	Москва и обл.	19892165	16887394	3004771	17.79
88	4	Юниаструм Банк	2771	Москва и обл.	64389462	61398148	2991314	4.87
207	41	Темпбанк	55	Москва и обл.	15047169	12062481	2984688	24.74
136	17	Приморье	3001	Приморский край	30705340	27834025	2871315	10.32
165	17	Алмазэргиэнбанк	2602	Саха (Якутия)	23722139	20856754	2865385	13.74
361	204	Приско Капитал Банк	2537	Москва и обл.	4788554	2010025	2778529	138.23
190	35	Тройка-Д Банк	3431	Москва и обл.	17445124	14667408	2777716	18.94
155	13	АктивКапитал Банк	3006	Самарская обл.	25967510	23422123	2545387	10.87
229	55	Нижневолжский Коммерческий Банк	931	Саратовская обл.	11430471	8893644	2536827	28.52
426	270	Мико-Банк	3195	Москва и обл.	3381095	859482	2521613	293.39
192	32	НК Банк	2755	Москва и обл.	17293046	14774293	2518753	17.05
116	11	Челиндбанк	485	Челябинская обл.	42296224	39781435	2514789	6.32
188	32	Развитие-Столица	3013	Москва и обл.	18114870	15647083	2467787	15.77
461	322	Еврокапитал-Альянс	2672	Ярославская обл.	2786919	324465	2462454	758.93
282	97	МС Банк Рус	2789	Москва и обл.	7631451	5179447	2452004	47.34
299	109	Ю Би Эс Банк	3463	Москва и обл.	7008214	4564320	2443894	53.54
279	95	Современный Коммерческий Ипотечный Банк	3329	Костромская обл.	7780975	5393499	2387476	44.27
72	7	Союз	2307	Москва и обл.	92553232	90222301	2330931	2.58
225	44	Русьуниверсалбанк	3293	Москва и обл.	12348433	10026075	2322358	23.16
223	42	Инбанк	1829	Москва и обл.	12490582	10201017	2289565	22.44
106	10	СДМ-Банк	1637	Москва и обл.	47658112	45376644	2281468	5.03
289	91	Союзный	3236	Москва и обл.	7435775	5162770	2273005	44.03
377	175	Капиталбанк	2547	Ростовская обл.	4390524	2118968	2271556	107.2
334	114	Ринвестбанк	3262	Рязанская обл.	5749444	3505481	2243963	64.01
268	72	Верхневолжский	1084	Ярославская обл.	8630585	6428045	2202540	34.26
240	50	Промтрансбанк	2638	Башкортостан	10783605	8664018	2119587	24.46
158	11	Тимер Банк	1581	Татарстан	25215968	23139491	2076477	8.97
250	58	Ассоциация	732	Нижегородская обл.	9878213	7885809	1992404	25.27
369	137	ФорБанк	2063	Москва и обл.	4630597	2679975	1950622	72.79
345	101	РТС-Банк	3401	Самарская обл.	5411133	3510958	1900175	54.12
397	172	Земкомбанк	574	Ростовская обл.	3775686	1899064	1876622	98.82
176	17	НБД-Банк	1966	Нижегородская обл.	20707831	18843856	1863975	9.89
312	90	Русский Трастовый Банк	1139	Москва и обл.	6509501	4668539	1840962	39.43
200	29	Гарант-Инвест	2576	Москва и обл.	15846151	14012276	1833875	13.09
218	40	Прио-Внешторгбанк	212	Рязанская обл.	13008951	11174841	1834110	16.41
319	92	Коммерческий Индо Банк	3446	Москва и обл.	6271630	4453223	1818407	40.83
242	41	Банк Жилищного Финансирования	3138	Москва и обл.	10684064	8911589	1772475	19.89
313	84	Воронеж	654	Воронежская обл.	6499671	4737706	1761965	37.19
254	57	Банк Казани	708	Татарстан	9363286	7657746	1705540	22.27
227	43	КС Банк	1752	Мордовия	11599914	9925972	1673942	16.86
485	217	Внешфинбанк	3173	Краснодарский край	2445101	804648	1640453	203.87
280	66	Синко-Банк	2838	Москва и обл.	7768186	6132118	1636068	26.68
170	13	Ланта-Банк	1920	Москва и обл.	22210505	20596730	1613775	7.84
236	39	Развитие	2729	Карачаево-Черкесия	10973888	9359052	1614836	17.25
293	70	Риабанк	3434	Москва и обл.	7223779	5653201	1570578	27.78
182	14	Курскпромбанк	735	Курская обл.	19453119	17891548	1561571	8.73
264	56	Вокбанк	312	Нижегородская обл.	8832439	7320994	1511445	20.65
169	12	Энерготрансбанк	1307	Калининградская обл.	22457903	20950520	1507383	7.19
438	143	Ростфинанс	481	Ростовская обл.	3220924	1721916	1499008	87.05
449	146	Банк Премьер Кредит	1663	Москва и обл.	3076655	1580287	1496368	94.69
295	66	Торговый Городской Банк	3180	Тверская обл.	7211381	5727897	1483484	25.9
288	64	Консервативный Коммерческий Банк	1087	Астраханская обл.	7507137	6028513	1478624	24.53
202	28	Русский Ипотечный Банк	1968	Москва и обл.	15367377	13899363	1468014	10.56
326	79	Межтрастбанк	2493	Москва и обл.	5998144	4611834	1386310	30.06
333	81	Нейва	1293	Свердловская обл.	5762628	4387308	1375320	31.35
141	11	Интехбанк	2705	Татарстан	29346043	27993244	1352799	4.83
366	94	Газтрансбанк	665	Адыгея	4649157	3304900	1344257	40.67
335	80	Мираф-Банк	2244	Омская обл.	5718304	4384095	1334209	30.43
425	132	Смартбанк	3408	Москва и обл.	3414201	2084019	1330182	63.83
336	80	Бинбанк Смоленск	1957	Смоленская обл.	5676186	4378423	1297763	29.64
405	118	Метрополь	1639	Москва и обл.	3675617	2395519	1280098	53.44
494	176	Тальменка-Банк	826	Алтайский край	2332670	1056147	1276523	120.87
338	81	Итуруп	2390	Сахалинская обл.	5526339	4259037	1267302	29.76
278	58	Эксперт Банк	2949	Омская обл.	7900991	6635798	1265193	19.07
457	134	Банк ВВБ	1093	Севастополь	2859686	1608107	1251579	77.83
484	168	Михайловский ПЖСБ	2961	Волгоградская обл.	2447057	1206672	1240385	102.79
488	170	Соверен Банк	3206	Москва и обл.	2381762	1153572	1228190	106.47
179	13	Нацинвестпромбанк	3077	Москва и обл.	20187058	18971941	1215117	6.4
209	24	Акцепт	567	Новосибирская обл.	14932481	13731675	1200806	8.74
422	107	Констанс-Банк	2228	Санкт-Петербург и обл.	3459651	2303481	1156170	50.19
285	56	Бинбанк Тверь	777	Тверская обл.	7523907	6376372	1147535	18
415	107	Московско-Парижский Банк	2646	Москва и обл.	3538981	2398082	1140899	47.58
444	120	Региональный Коммерческий Банк	836	Ульяновская обл.	3153258	2030704	1122554	55.28
477	138	Промышленно-Финансовое Сотрудничество	2410	Москва и обл.	2540451	1421093	1119358	78.77
566	216	Регнум	3373	Москва и обл.	1437759	333466	1104293	331.16
193	23	Хлынов	254	Кировская обл.	17115331	16016206	1099125	6.86
238	33	СИАБ	3245	Санкт-Петербург и обл.	10807780	9722658	1085122	11.16
153	6	Акибанк	2587	Татарстан	26607584	25529560	1078024	4.22
216	27	Дил-Банк	3384	Москва и обл.	13707960	12650687	1057273	8.36
448	113	Лайтбанк	3177	Москва и обл.	3104832	2051590	1053242	51.34
419	98	Н-Банк	3493	Москва и обл.	3511307	2472897	1038410	41.99
323	59	Экси-Банк	2530	Санкт-Петербург и обл.	6126992	5108155	1018837	19.95
222	34	Солидарность (Москва)	1555	Москва и обл.	12514847	11499490	1015357	8.83
291	52	Чувашкредитпромбанк	1280	Чувашия	7258465	6255928	1002537	16.03
402	101	Выборг-Банк	720	Санкт-Петербург и обл.	3707876	2716135	991741	36.51
174	11	Аресбанк	2914	Москва и обл.	21250792	20268026	982766	4.85
262	44	Северо-Восточный Альянс	2768	Москва и обл.	8865073	7923605	941468	11.88
248	30	Славия	2664	Москва и обл.	10141643	9209229	932414	10.12
337	63	Автоградбанк	1455	Татарстан	5606025	4691080	914945	19.5
349	69	Владпромбанк	870	Владимирская обл.	5217975	4304355	913620	21.23
226	31	Солид Банк	1329	Камчатская обл.	12127937	11215007	912930	8.14
431	93	Сибэс	208	Омская обл.	3307117	2394512	912605	38.11
154	7	Москоммерцбанк	3365	Москва и обл.	26260376	25374586	885790	3.49
383	82	Прайм Финанс	2758	Санкт-Петербург и обл.	4135941	3251679	884262	27.19
274	41	Юг-Инвестбанк	2772	Краснодарский край	8356750	7504201	852549	11.36
328	53	Идея Банк	430	Краснодарский край	5951602	5110002	841600	16.47
406	87	Евразийский Банк	969	Москва и обл.	3664450	2825532	838918	29.69
284	51	Славянский Кредит	2960	Москва и обл.	7549773	6713837	835936	12.45
404	82	Объединенный Резервный Банк	937	Москва и обл.	3704698	2905389	799309	27.51
357	63	Новобанк	1352	Новгородская обл.	4955659	4165320	790339	18.97
501	110	Миръ	3089	Москва и обл.	2224145	1436500	787645	54.83
414	83	Донхлеббанк	2285	Ростовская обл.	3545470	2760813	784657	28.42
373	62	Уссури	596	Хабаровский край	4512186	3742407	769779	20.57
275	41	РусЮгбанк	2093	Волгоградская обл.	8241611	7477034	764577	10.23
396	80	Агророс	2860	Саратовская обл.	3796118	3048435	747683	24.53
380	67	Венец	524	Ульяновская обл.	4244193	3506676	737517	21.03
340	55	Енисейский Объединенный Банк	2645	Красноярский край	5500513	4777906	722607	15.12
362	60	Земский Банк	2900	Самарская обл.	4784209	4069140	715069	17.57
508	113	Кредпромбанк	1165	Ярославская обл.	2095161	1391023	704138	50.62
410	79	Банкирский Дом	2928	Санкт-Петербург и обл.	3577688	2878861	698827	24.27
259	37	Снежинский	1376	Челябинская обл.	9149543	8461610	687933	8.13
385	70	Форус Банк	3457	Нижегородская обл.	4111135	3431637	679498	19.8
294	43	Век	2299	Москва и обл.	7213831	6537869	675962	10.34
453	77	Радиотехбанк	1166	Нижегородская обл.	2966138	2296858	669280	29.14
443	70	Иваново	1763	Ивановская обл.	3162815	2499702	663113	26.53
582	156	Арсенал	3000	Москва и обл.	1225030	569239	655791	115.2
317	43	Нэклис-Банк	1671	Москва и обл.	6411235	5759595	651640	11.31
311	44	Эргобанк	2856	Москва и обл.	6546524	5901671	644853	10.93
399	74	БайкалИнвестБанк	1067	Иркутская обл.	3731550	3100984	630566	20.33
379	57	Финансово-Промышленный Капитал	3295	Москва и обл.	4366112	3742254	623858	16.67
263	37	Таатта	1249	Саха (Якутия)	8845172	8228279	616893	7.5
423	69	Кубанский Универсальный Банк	2898	Краснодарский край	3454653	2838615	616038	21.7
260	38	Ижкомбанк	646	Удмуртия	8894474	8278915	615559	7.44
526	118	Булгар Банк	1917	Татарстан	1861691	1258872	602819	47.89
341	51	Газстройбанк	2919	Москва и обл.	5480556	4882908	597648	12.24
407	67	Аксонбанк	680	Костромская обл.	3656481	3075170	581311	18.9
452	68	Первый Клиентский Банк	3436	Москва и обл.	2991255	2410321	580934	24.1
437	70	Братский АНКБ	1144	Иркутская обл.	3247262	2670704	576558	21.59
253	35	Новопокровский	467	Краснодарский край	9392165	8818051	574114	6.51
272	37	Томскпромстройбанк	1720	Томская обл.	8442573	7875402	567171	7.2
398	72	МФБанк	3163	Москва и обл.	3745267	3178151	567116	17.84
239	25	Оренбург	3269	Оренбургская обл.	10805390	10246859	558531	5.45
506	86	Екатерининский	2167	Москва и обл.	2156854	1601650	555204	34.66
502	83	Далена	1948	Москва и обл.	2221645	1670583	551062	32.99
541	112	РУБанк	2813	Москва и обл.	1726380	1180307	546073	46.27
374	52	Промсельхозбанк	538	Москва и обл.	4496002	4000320	495682	12.39
343	44	Банк Раунд	2506	Москва и обл.	5434099	4946333	487766	9.86
301	38	Банк на Красных Воротах	2472	Москва и обл.	6916530	6429029	487501	7.58
542	109	Кемсоцинбанк	96	Кемеровская обл.	1694451	1211366	483085	39.88
583	129	Динамичные Системы	3439	Москва и обл.	1219769	742063	477706	64.38
305	39	Кузнецкбизнесбанк	1158	Кемеровская обл.	6667224	6191837	475387	7.68
505	78	Торжокуниверсалбанк	933	Тверская обл.	2160795	1695585	465210	27.44
307	38	Эл Банк	1025	Самарская обл.	6593412	6133245	460167	7.5
475	81	Канский	860	Красноярский край	2546093	2090233	455860	21.81
440	60	Интеркредит	3047	Москва и обл.	3188758	2732793	455965	16.68
595	128	Южный Региональный Банк	3015	Ростовская обл.	1118583	668523	450060	67.32
221	25	Международный Акционерный Банк	1987	Москва и обл.	12713317	12264592	448725	3.66
519	83	ЮМК	3495	Краснодарский край	1947154	1502491	444663	29.6
104	7	Фора-Банк	1885	Москва и обл.	47724048	47279231	444817	0.94
589	124	Космос	2245	Москва и обл.	1182618	741963	440655	59.39
382	55	Роял Кредит Банк	783	Хабаровский край	4171708	3731774	439934	11.79
430	60	Центрально-Европейский Банк	2670	Москва и обл.	3308618	2870896	437722	15.25
576	110	Банк РМП	2574	Москва и обл.	1353074	916573	436501	47.62
287	35	Северный Кредит	2398	Вологодская обл.	7521079	7089954	431125	6.08
389	61	Русский Национальный Банк	469	Ростовская обл.	3902794	3473023	429771	12.37
256	30	Миллениум Банк	3423	Москва и обл.	9275519	8859090	416429	4.7
381	52	Камчаткомагропромбанк	545	Камчатская обл.	4221768	3812234	409534	10.74
468	71	Система	2846	Москва и обл.	2628570	2220924	407646	18.35
318	35	Кремлевский	2905	Москва и обл.	6404503	5997190	407313	6.79
178	8	Энергобанк	67	Татарстан	20537611	20131090	406521	2.02
469	69	Кредит Экспресс	3186	Ростовская обл.	2616536	2222867	393669	17.71
413	58	Живаго-Банк	2065	Рязанская обл.	3556737	3169966	386771	12.2
447	54	Яндекс.Деньги	3510	Россия	3113796	2727831	385965	14.15
393	61	Вологжанин	1896	Вологодская обл.	3835921	3450536	385385	11.17
412	57	Бест Эффортс Банк	435	Москва и обл.	3557080	3179824	377256	11.86
540	85	Межрегиональный Клиринговый Банк	2543	Москва и обл.	1739928	1369811	370117	27.02
548	100	1Банк	2896	Северная Осетия — Алания	1594867	1237764	357103	28.85
386	52	Витабанк	356	Санкт-Петербург и обл.	4083034	3727970	355064	9.52
458	57	Кроссинвестбанк	2849	Москва и обл.	2842938	2492312	350626	14.07
376	45	Кузнецкий	609	Пензенская обл.	4438072	4091542	346530	8.47
191	11	Расчетно-Кредитный Банк	103	Москва и обл.	17326725	16983574	343151	2.02
578	103	ПэйПал РУ	3517	Москва и обл.	1292588	952596	339992	35.69
532	75	Вологдабанк	992	Вологодская обл.	1813058	1473600	339458	23.04
471	64	Проинвестбанк	784	Пермская обл.	2585471	2250647	334824	14.88
534	74	Кетовский Коммерческий Банк	842	Курганская обл.	1787144	1464241	322903	22.05
470	61	Йошкар-Ола	2802	Марий Эл	2604872	2284455	320417	14.03
296	36	Муниципальный Камчатпрофитбанк	2103	Камчатская обл.	7138784	6818527	320257	4.7
564	91	Евроазиатский Инвестиционный Банк	2897	Москва и обл.	1493706	1175177	318529	27.1
584	103	Тендер-Банк	2252	Москва и обл.	1215979	915138	300841	32.87
411	52	Уралпромбанк	2964	Челябинская обл.	3573762	3282957	290805	8.86
212	20	БайкалБанк	2632	Бурятия	14106854	13817287	289567	2.1
490	68	Новация	840	Адыгея	2371157	2081262	289895	13.93
442	46	Мегаполис	3265	Чувашия	3182459	2893463	288996	9.99
533	68	Руна-Банк	3207	Москва и обл.	1797115	1508893	288222	19.1
512	67	Уралфинанс	1370	Свердловская обл.	2036633	1749603	287030	16.41
516	66	Мосводоканалбанк	2863	Москва и обл.	2005590	1718954	286636	16.68
330	36	Хакасский Муниципальный Банк	1049	Хакасия	5888530	5602993	285537	5.1
613	105	Первоуральскбанк	965	Свердловская обл.	981480	697034	284446	40.81
556	89	Оней Банк	3516	Москва и обл.	1540248	1258650	281598	22.37
478	56	Владбизнесбанк	903	Владимирская обл.	2539316	2261117	278199	12.3
600	106	Москва	1661	Москва и обл.	1063879	785993	277886	35.35
553	82	Ноосфера	2650	Республика Алтай	1564310	1301915	262395	20.15
522	64	Америкэн Экспресс Банк	3460	Москва и обл.	1914641	1653967	260674	15.76
346	39	Камский Коммерческий Банк	438	Татарстан	5337730	5086036	251694	4.95
612	99	Московский Национальный Инвестиционный Банк	3181	Москва и обл.	982876	749611	233265	31.12
536	62	Майкопбанк	1136	Адыгея	1768764	1535569	233195	15.19
633	103	Межрегиональный Банк Реконструкции	2620	Москва и обл.	806272	575617	230655	40.07
550	79	Примтеркомбанк	21	Приморский край	1577183	1347537	229646	17.04
614	101	Кузбассхимбанк	2868	Кемеровская обл.	960603	739127	221476	29.96
356	40	Конфидэнс Банк	970	Костромская обл.	4963766	4746026	217740	4.59
481	52	Унифондбанк	3416	Москва и обл.	2482124	2272232	209892	9.24
205	16	Росавтобанк	2767	Москва и обл.	15164035	14957126	206909	1.38
650	119	Терра	3476	Москва и обл.	610465	407741	202724	49.72
685	114	Монета.ру	3508	Марий Эл	365359	164833	200526	121.65
329	33	Северный Народный Банк	2721	Коми	5902967	5707403	195564	3.43
474	53	Газнефтьбанк	3223	Саратовская обл.	2546713	2354102	192611	8.18
593	86	Камский Горизонт	2554	Татарстан	1149427	957421	192006	20.05
598	92	Тетраполис	1586	Санкт-Петербург и обл.	1087731	901048	186683	20.72
696	112	Универсальная электронная карта	3524	Москва и обл.	265405	79265	186140	234.83
451	40	Аспект	608	Москва и обл.	3035050	2851527	183523	6.44
565	76	Первый Дортрансбанк	3271	Кировская обл.	1449380	1267143	182237	14.38
531	58	Мострансбанк	2258	Москва и обл.	1819213	1636942	182271	11.13
300	31	Трансстройбанк	2807	Москва и обл.	7007445	6832510	174935	2.56
682	113	РИБ	2749	Москва и обл.	388737	214063	174674	81.6
551	66	Великие Луки Банк	598	Псковская обл.	1574847	1401267	173580	12.39
320	29	Кранбанк	2271	Ивановская обл.	6262099	6089914	172185	2.83
585	89	Химик	1114	Нижегородская обл.	1196427	1024446	171981	16.79
636	98	РусьРегионБанк	685	Москва и обл.	763781	592936	170845	28.81
360	43	ВостСибтранскомбанк	2731	Иркутская обл.	4812604	4646810	165794	3.57
491	51	БСТ-Банк	2883	Кемеровская обл.	2370338	2204843	165495	7.51
703	111	Инновационный Расчетный Центр	3447	Москва и обл.	193905	31166	162739	522.17
292	31	Анкор Банк	889	Татарстан	7246739	7086055	160684	2.27
704	112	Интеррасчет	1618	Москва и обл.	187041	26913	160128	594.98
306	32	Банк Торгового Финансирования	1982	Москва и обл.	6647149	6489264	157885	2.43
408	41	Инвестсоцбанк	3010	Москва и обл.	3652688	3496849	155839	4.46
359	39	Межрегиональный промышленно-строительный банк	752	Мордовия	4890837	4735504	155333	3.28
420	38	Юнистрим	3467	Москва и обл.	3499389	3346063	153326	4.58
568	69	РФИ Банк	3351	Москва и обл.	1432609	1280802	151807	11.85
546	57	Вэлтон Банк	1105	Белгородская обл.	1649418	1497653	151765	10.13
492	49	Резерв	2364	Челябинская обл.	2358966	2209436	149530	6.77
611	88	Спецстройбанк	236	Москва и обл.	997033	851321	145712	17.12
631	93	Вестинтербанк	3398	Москва и обл.	813385	668012	145373	21.76
401	42	Айви Банк	2055	Москва и обл.	3714564	3573433	141131	3.95
124	13	Саровбизнесбанк	2048	Нижегородская обл.	36251912	36112344	139568	0.39
623	87	Русский Финансовый Альянс	2035	Москва и обл.	900049	759472	140577	18.51
654	107	Азия Банк	3183	Москва и обл.	596088	459130	136958	29.83
327	31	Проминвестбанк	2433	Москва и обл.	5989690	5853680	136010	2.32
574	72	Взаимодействие	1704	Новосибирская обл.	1382603	1247484	135119	10.83
524	53	Глобус	2438	Москва и обл.	1889400	1755956	133444	7.6
642	95	Геобанк	2027	Москва и обл.	704121	573187	130934	22.84
624	85	Майский	1673	Кабардино-Балкария	891186	765702	125484	16.39
609	82	Невастройинвест	1926	Санкт-Петербург и обл.	1011756	888669	123087	13.85
555	59	Калуга	1151	Калужская обл.	1543614	1427325	116289	8.15
622	85	Центрально-Азиатский	3037	Хакасия	900669	784995	115674	14.74
629	88	Народный Инвестиционный Банк	2876	Самарская обл.	819982	708615	111367	15.72
561	59	Вятич	2796	Рязанская обл.	1500006	1392510	107496	7.72
460	45	Межбанковский Кредитный Союз	3242	Москва и обл.	2801085	2693505	107580	3.99
513	55	Индустриальный Сберегательный Банк	3175	Москва и обл.	2034682	1927298	107384	5.57
557	55	Соколовский	2830	Москва и обл.	1539609	1435787	103822	7.23
547	52	Приобье	537	Ханты-Мансийский АО — Югра	1618801	1522921	95880	6.3
640	85	Русский Банк Сбережений	779	Ставропольский край	749660	663459	86201	12.99
496	48	Златкомбанк	568	Москва и обл.	2265506	2179894	85612	3.93
520	51	Старооскольский Агропромбанк	1050	Белгородская обл.	1936746	1854401	82345	4.44
560	53	Спутник	1071	Оренбургская обл.	1509651	1428471	81180	5.68
577	65	Саммит Банк	85	Приморский край	1345615	1264504	81111	6.41
215	19	Пойдем!	2534	Москва и обл.	13779409	13703949	75460	0.55
697	103	Русское Финансовое Общество	3427	Москва и обл.	237600	163547	74053	45.28
417	36	Зираат Банк	2559	Москва и обл.	3527564	3455606	71958	2.08
476	40	Вестерн Юнион ДП Восток	2726	Москва и обл.	2544514	2483312	61202	2.46
628	75	Славянбанк	804	Новгородская обл.	861242	801580	59662	7.44
655	87	АвтоКредитБанк	1973	Татарстан	595849	540283	55566	10.28
621	74	Вакобанк	1291	Псковская обл.	923446	867980	55466	6.39
646	87	АлтайБизнес-Банк	2388	Алтайский край	656709	603210	53499	8.87
607	69	Курган	2568	Курганская обл.	1039874	987648	52226	5.29
563	46	Гринкомбанк	1184	Иркутская обл.	1494436	1446709	47727	3.3
648	84	Гефест	1046	Тверская обл.	650068	606578	43490	7.17
618	74	Классик Эконом Банк	3298	Северная Осетия — Алания	929326	887117	42209	4.76
486	35	ИРС	272	Москва и обл.	2441123	2401653	39470	1.64
625	75	Тексбанк	2756	Карачаево-Черкесия	884564	846902	37662	4.45
390	42	Горбанк	2982	Санкт-Петербург и обл.	3871569	3834035	37534	0.98
467	43	Богородский	1277	Нижегородская обл.	2641702	2604098	37604	1.44
610	68	Байкалкредобанк	2990	Иркутская обл.	1007966	970690	37276	3.84
702	96	Красноярский Краевой Расчетный Центр	3483	Красноярский край	215896	179326	36570	20.39
596	72	Русский Элитарный Банк	3231	Москва и обл.	1099141	1063120	36021	3.39
671	92	Эко-Инвест	3116	Москва и обл.	464682	439172	25510	5.81
666	94	МВС Банк	2407	Дагестан	488250	465744	22506	4.83
679	94	Тульский Расчетный Центр	3380	Тульская обл.	405742	386262	19480	5.04
432	30	Крокус-Банк	2682	Москва и обл.	3304521	3285336	19185	0.58
719	99	21 Век	3309	Санкт-Петербург и обл.	27256	9277	17979	193.8
571	48	Почтобанк	1788	Пермская обл.	1412392	1395827	16565	1.19
659	90	Башпромбанк	1006	Башкортостан	525778	509325	16453	3.23
673	91	Таганрогбанк	3136	Ростовская обл.	438504	422092	16412	3.89
720	101	АРБ-Инкасс	3353	Москва и обл.	17856	2998	14858	495.6
592	67	Финарс Банк	2938	Москва и обл.	1161064	1146296	14768	1.29
678	92	Информпрогресс	2166	Москва и обл.	415298	400942	14356	3.58
527	46	Акцент	696	Оренбургская обл.	1850214	1836206	14008	0.76
687	93	Рунэтбанк	2829	Москва и обл.	358944	345106	13838	4.01
663	91	Дружба	990	Тюменская обл.	503779	490718	13061	2.66
711	94	Вест	2605	Москва и обл.	100796	89551	11245	12.56
479	33	K2 Банк	2851	Карачаево-Черкесия	2526348	2515158	11190	0.44
669	87	Европейский Стандарт	3200	Кабардино-Балкария	486282	475287	10995	2.31
698	96	Майма	1037	Москва и обл.	226153	215966	10187	4.72
658	83	Энтузиастбанк	3048	Москва и обл.	561023	551489	9534	1.73
617	68	Ресурс-Траст	3122	Москва и обл.	933987	926308	7679	0.83
575	53	Синергия	2884	Саратовская обл.	1371915	1364852	7063	0.52
684	92	Лэнд-Банк	1478	Москва и обл.	378316	371842	6474	1.74
712	94	КредитАльянс	3472	Вологодская обл.	94979	88535	6444	7.28
683	92	Банк Сберегательно-кредитного сервиса	3224	Москва и обл.	385835	379466	6369	1.68
718	94	Транзит	2688	Дагестан	41519	35362	6157	17.41
303	30	Русь	704	Оренбургская обл.	6764786	6758686	6100	0.09
605	68	Мурманский Социальный Коммерческий Банк	2722	Мурманская обл.	1048048	1042768	5280	0.51
635	70	Народный Земельно-Промышленный Банк	2873	Алтайский край	793186	788037	5149	0.65
693	92	Северстройбанк	3507	Вологодская обл.	323114	318796	4318	1.35
660	86	Иронбанк	1724	Москва и обл.	520368	517847	2521	0.49
688	90	Тайдон	2085	Кемеровская обл.	356943	355191	1752	0.49
421	31	Наш Дом	3296	Москва и обл.	3470207	3468307	1900	0.05
661	87	Народный Банк Республики Тыва	1309	Тыва	516824	515232	1592	0.31
463	32	Заубер Банк	1614	Санкт-Петербург и обл.	2767244	2766609	635	0.02
722	98	Клиринговый Дом	3430	Санкт-Петербург и обл.	4318	4208	110	2.61
350		Кореа Эксчендж Банк Рус	3525	Москва и обл.	5169988			
384		Чайнасельхозбанк	3529	Москва и обл.	4129408			
465	33	Костромаселькомбанк	1115	Костромская обл.	2755517	2758075	-2558	-0.09
539	39	Дом-Банк	3209	Москва и обл.	1749007	1752916	-3909	-0.22
464	32	Кросна-Банк	2607	Москва и обл.	2756487	2764670	-8183	-0.3
529	43	КОР	2148	Волгоградская обл.	1839079	1846601	-7522	-0.41
493	33	Татагропромбанк	728	Татарстан	2352605	2361918	-9313	-0.39
567	43	Арзамас	1281	Нижегородская обл.	1433388	1440897	-7509	-0.52
644	78	Балаково-Банк	444	Саратовская обл.	679778	685501	-5723	-0.83
246	17	Нико-Банк	702	Оренбургская обл.	10363527	10388681	-25154	-0.24
606	65	Московский Клиринговый Центр	3314	Москва и обл.	1047646	1055966	-8320	-0.79
691	88	ФФИН Банк (бывш. Охабанк)	1143	Сахалинская обл.	341722	346853	-5131	-1.48
651	80	Холдинвестбанк	2837	Москва и обл.	604011	613270	-9259	-1.51
632	69	Прохладный	874	Кабардино-Балкария	806395	819637	-13242	-1.62
482	32	Национальный Корпоративный Банк	3422	Москва и обл.	2469866	2493099	-23233	-0.93
667	83	Кредо Финанс	793	Дагестан	488238	499447	-11209	-2.24
503	33	Новый Символ	370	Москва и обл.	2220085	2244072	-23987	-1.07
395	36	Руссобанк	2313	Москва и обл.	3804503	3836427	-31924	-0.83
277	25	Рускобанк	138	Санкт-Петербург и обл.	8062152	8110547	-48395	-0.6
435	26	Алтайкапиталбанк	2659	Алтайский край	3269162	3301488	-32326	-0.98
514	49	Алтынбанк	2070	Татарстан	2022682	2048263	-25581	-1.25
456	28	Интерактивный Банк	3378	Москва и обл.	2883744	2915760	-32016	-1.1
562	38	Инкаробанк	2696	Москва и обл.	1496667	1522053	-25386	-1.67
261	21	Банк БКФ	2684	Москва и обл.	8879856	8942690	-62834	-0.7
699	93	Расчетная Палата СВМБ	3324	Самарская обл.	225891	236242	-10351	-4.38
504	33	Капитал	575	Москва и обл.	2194772	2232948	-38176	-1.71
332	22	Банк Оранжевый	1659	Санкт-Петербург и обл.	5854129	5918539	-64410	-1.09
672	86	Берейт	3505	Санкт-Петербург и обл.	453604	471965	-18361	-3.89
715	94	Платежный Клиринговый Дом	3343	Москва и обл.	65132	72455	-7323	-10.11
601	61	ЕАТП Банк	1765	Астраханская обл.	1062758	1092642	-29884	-2.74
559	37	Новый Кредитный Союз	3139	Москва и обл.	1526368	1563016	-36648	-2.34
619	61	Акция	927	Ивановская обл.	924648	955056	-30408	-3.18
515	45	Московский Вексельный Банк	2697	Москва и обл.	2006188	2052885	-46697	-2.27
591	59	НоваховКапиталБанк	635	Москва и обл.	1177963	1215994	-38031	-3.13
342	27	Мосуралбанк	2468	Москва и обл.	5462552	5547295	-84743	-1.53
670	81	Стар Альянс	3433	Москва и обл.	473331	498767	-25436	-5.1
587	62	Новый Промышленный Банк	930	Москва и обл.	1189889	1229986	-40097	-3.26
544	36	Банк МБФИ	2073	Москва и обл.	1684187	1732512	-48325	-2.79
429	28	Росбизнесбанк	1405	Москва и обл.	3316004	3384444	-68440	-2.02
705	91	Электронный платежный сервис	3509	Москва и обл.	186653	204288	-17635	-8.63
647	74	Банк РСИ	3415	Москва и обл.	655093	687965	-32872	-4.78
637	67	Стандарт-Кредит	841	Адыгея	761762	798606	-36844	-4.61
608	61	Онего	2484	Карелия	1019876	1062931	-43055	-4.05
653	77	ВРБ Москва	3499	Москва и обл.	600586	633847	-33261	-5.25
161	3	Уральский Финансовый Дом	249	Пермская обл.	24643264	24863451	-220187	-0.89
652	76	Новокиб	1747	Кемеровская обл.	603630	640383	-36753	-5.74
676	86	Альтернатива	3452	Москва и обл.	426554	457649	-31095	-6.79
459	26	Евроальянс	1781	Ивановская обл.	2834395	2913411	-79016	-2.71
716	95	Сергиево-Посадская Расчетная Палата	384	Москва и обл.	55882	68042	-12160	-17.87
198	13	Уралтрансбанк	812	Свердловская обл.	16268903	16458435	-189532	-1.15
22	-3	Русский Стандарт	2289	Москва и обл.	460563326	461568053	-1004727	-0.22
510	39	Бум-Банк	1137	Кабардино-Балкария	2069065	2138867	-69802	-3.26
489	29	Первый Инвестиционный банк	604	Москва и обл.	2371218	2452085	-80867	-3.3
509	37	Спиритбанк	2053	Тульская обл.	2073117	2148883	-75766	-3.53
700	90	Континент Финанс	149	Москва и обл.	222793	249318	-26525	-10.64
499	29	Яринтербанк	2564	Ярославская обл.	2228750	2318362	-89612	-3.87
210	13	ТЭМБР-Банк	2764	Москва и обл.	14597257	14825413	-228156	-1.54
580	53	Сервис-Резерв	2034	Москва и обл.	1251450	1321463	-70013	-5.3
353	23	Сибсоцбанк	2015	Алтайский край	5113152	5256765	-143613	-2.73
273	18	ПИР Банк	2655	Москва и обл.	8422975	8611819	-188844	-2.19
630	64	Флора-Москва	533	Москва и обл.	818891	880019	-61128	-6.95
572	34	Саратов	330	Саратовская обл.	1395717	1475799	-80082	-5.43
616	59	Си Ди Би Банк	3339	Краснодарский край	946968	1014162	-67194	-6.63
249	18	Энергомашбанк	52	Санкт-Петербург и обл.	9882559	10097884	-215325	-2.13
518	36	Пермь	875	Пермская обл.	2001216	2099692	-98476	-4.69
602	58	Дон-Тексбанк	1818	Ростовская обл.	1062135	1137320	-75185	-6.61
276	21	Альба Альянс	2593	Москва и обл.	8179879	8390319	-210440	-2.51
434	22	Нокссбанк	3202	Волгоградская обл.	3286819	3421236	-134417	-3.93
717	93	Премиум	3514	Москва и обл.	51335	70963	-19628	-27.66
657	70	СМБ-Банк	3504	Санкт-Петербург и обл.	582081	643497	-61416	-9.54
645	71	РИТЦ Банк	2677	Москва и обл.	666891	732544	-65653	-8.96
367	26	Зенит Сочи	232	Краснодарский край	4631615	4814164	-182549	-3.79
706	87	Деньги.Мэйл.Ру	3511	Москва и обл.	180888	220495	-39607	-17.96
441	18	Церих	3278	Орловская обл.	3187906	3345163	-157257	-4.7
498	27	Международный Строительный Банк	3484	Москва и обл.	2247703	2385843	-138140	-5.79
665	75	Логос	3233	Москва и обл.	497238	565250	-68012	-12.03
626	51	Новый Век	3417	Москва и обл.	882328	978267	-95939	-9.81
378	28	Сибирский Банк Реконструкции и Развития	1284	Тюменская обл.	4386782	4594824	-208042	-4.53
189	6	Алеф-Банк	2119	Москва и обл.	17602440	18017021	-414581	-2.3
713	91	Банковские Информационные Технологии	3318	Тульская обл.	78262	111086	-32824	-29.55
680	79	Рента-Банк	3095	Москва и обл.	402806	471542	-68736	-14.58
721	92	Частный Расчетно-Кассовый Центр	3420	Москва и обл.	13992	32425	-18433	-56.85
394	29	Интернациональный Торговый Банк	2609	Омская обл.	3832231	4038480	-206249	-5.11
545	30	Тагилбанк	1635	Свердловская обл.	1656600	1795310	-138710	-7.73
638	60	Уралприватбанк	153	Свердловская обл.	759717	856285	-96568	-11.28
690	76	НКБ	2942	Москва и обл.	348164	415805	-67641	-16.27
603	53	Регионфинансбанк	3357	Москва и обл.	1059621	1173956	-114335	-9.74
365	25	Промэнергобанк	2728	Вологодская обл.	4688680	4924423	-235743	-4.79
570	27	Жилкредит	1736	Москва и обл.	1417934	1556265	-138331	-8.89
473	26	Апабанк	2404	Москва и обл.	2556531	2740356	-183825	-6.71
4	0	ВТБ 24	1623	Москва и обл.	2873642255	2879597990	-5955735	-0.21
175	2	ФИА-Банк	2542	Самарская обл.	20923758	21484708	-560950	-2.61
270	17	Московский Нефтехимический Банк	1411	Москва и обл.	8459969	8822532	-362563	-4.11
668	67	АББ	2937	Москва и обл.	486412	581744	-95332	-16.39
466	17	ЕвроАксис Банк	3273	Москва и обл.	2710901	2934372	-223471	-7.62
403	26	Мастер-Капитал	3011	Москва и обл.	3705583	3966378	-260795	-6.58
597	50	Акрополь	3027	Москва и обл.	1091477	1241975	-150498	-12.12
129	12	Русстройбанк	3205	Москва и обл.	33893169	34689907	-796738	-2.3
543	27	Икано Банк	3519	Центр	1687103	1872585	-185482	-9.91
681	72	Континенталь	3184	Ставропольский край	396869	492398	-95529	-19.4
537	29	Нальчик	695	Кабардино-Балкария	1768378	1975340	-206962	-10.48
371	20	Банк Развития Технологий	3441	Москва и обл.	4566994	4893342	-326348	-6.67
714	88	Умут	2435	Дагестан	75326	128762	-53436	-41.5
185	6	Рублев	3098	Москва и обл.	18438727	19097649	-658922	-3.45
709	88	Фидбэк	3502	Москва и обл.	129947	196882	-66935	-34
581	35	МТИ-Банк	1052	Москва и обл.	1225159	1417737	-192578	-13.58
122	6	Кольцо Урала	65	Свердловская обл.	38152691	39168849	-1016158	-2.59
588	36	Национальный Банк Взаимного Кредита	3214	Москва и обл.	1184069	1379228	-195159	-14.15
694	73	Нарат	1902	Саратовская обл.	307405	415124	-107719	-25.95
454	13	Тамбовкредитпромбанк	1312	Тамбовская обл.	2901765	3202057	-300292	-9.38
416	14	Веста	2368	Москва и обл.	3537304	3867720	-330416	-8.54
228	19	Первомайский	518	Краснодарский край	11507303	12093650	-586347	-4.85
649	59	Прокоммерцбанк	2996	Москва и обл.	616816	768297	-151481	-19.72
674	65	Алжан	2491	Дагестан	436091	568449	-132358	-23.28
599	40	Металлург	2877	Москва и обл.	1080206	1279689	-199483	-15.59
372	14	Экономикс-Банк	2136	Москва и обл.	4560262	4953391	-393129	-7.94
199	9	Петербургский Социальный Коммерческий Банк	2551	Санкт-Петербург и обл.	15965475	16696612	-731137	-4.38
495	14	Викинг	2	Санкт-Петербург и обл.	2321699	2611403	-289704	-11.09
525	25	Россита-Банк	3257	Москва и обл.	1873773	2138368	-264595	-12.37
310	15	Актив Банк	2529	Мордовия	6547498	7030366	-482868	-6.87
643	54	Турбобанк	3203	Санкт-Петербург и обл.	688170	857737	-169567	-19.77
302	16	Азия-Инвест Банк	3303	Москва и обл.	6910754	7409550	-498796	-6.73
445	6	Океан Банк	1697	Москва и обл.	3128233	3470717	-342484	-9.87
686	66	ОЛМА-Банк	3250	Москва и обл.	364502	498006	-133504	-26.81
455	11	РБА	3413	Москва и обл.	2888258	3229999	-341741	-10.58
351	14	Донкомбанк	492	Ростовская обл.	5153821	5610678	-456857	-8.14
315	12	РЕСО Кредит	3450	Москва и обл.	6444090	6954154	-510064	-7.33
344	13	Промрегионбанк	2123	Томская обл.	5423065	5894641	-471576	-8
695	77	Приполярком	507	Тюменская обл.	271335	394256	-122921	-31.18
530	21	Социум-Банк	2881	Москва и обл.	1837207	2125098	-287891	-13.55
627	38	Эльбин	2267	Дагестан	867839	1076658	-208819	-19.4
523	20	Риал-Кредит	3393	Москва и обл.	1896195	2197772	-301577	-13.72
639	43	Анелик РУ	3443	Москва и обл.	751714	949980	-198266	-20.87
82	4	Банк Интеза	2216	Москва и обл.	73568451	75366881	-1798430	-2.39
142	4	Дальневосточный Банк	843	Приморский край	29323206	30477297	-1154091	-3.79
436	4	Долинск	857	Сахалинская обл.	3257561	3671734	-414173	-11.28
528	17	Стелла-Банк	2948	Ростовская обл.	1839473	2162740	-323267	-14.95
354	14	Национальный Залоговый Банк	2944	Москва и обл.	5060130	5584716	-524586	-9.39
314	10	Новый Московский Банк	2932	Москва и обл.	6447996	7036993	-588997	-8.37
594	24	Финтрастбанк	3104	Москва и обл.	1133371	1395855	-262484	-18.8
620	37	Объединенный Банк Республики	1016	Чувашия	924142	1171906	-247764	-21.14
573	11	Пульс Столицы	3002	Москва и обл.	1384697	1682216	-297519	-17.69
521	11	Бинбанк Сургут	1701	Ханты-Мансийский АО — Югра	1933209	2282204	-348995	-15.29
283	16	Белгородсоцбанк	760	Белгородская обл.	7598159	8265411	-667252	-8.07
641	42	Расчетный Дом	3350	Москва и обл.	720587	949043	-228456	-24.07
156	1	Липецккомбанк	1242	Липецкая обл.	25605653	26820599	-1214946	-4.53
538	17	Холмск	503	Сахалинская обл.	1753329	2093808	-340479	-16.26
446	-2	Элита	1399	Калужская обл.	3114124	3561816	-447692	-12.57
206	9	Национальный Резервный Банк	2170	Москва и обл.	15069713	16021824	-952111	-5.94
358	15	Московский Коммерческий Банк	3172	Москва и обл.	4891539	5457248	-565709	-10.37
418	7	Уральский Межрегиональный Банк	1441	Свердловская обл.	3513042	4016394	-503352	-12.53
604	26	Республиканский Кредитный Альянс	3017	Москва и обл.	1054509	1346262	-291753	-21.67
535	13	Крона-Банк	2499	Иркутская обл.	1769625	2139126	-369501	-17.27
252	10	Ставропольпромстройбанк	1288	Ставропольский край	9580120	10394539	-814419	-7.84
220	11	Нефтяной Альянс	2859	Москва и обл.	12900760	13854375	-953615	-6.88
692	53	Бринкс	3486	Москва и обл.	336866	527549	-190683	-36.15
701	73	Сетевая Расчетная Палата	3332	Татарстан	217565	380736	-163171	-42.86
111	2	Банк «МБА-Москва»	3395	Москва и обл.	45259943	47110571	-1850628	-3.93
708	79	Единая касса	3512	Москва и обл.	143407	289360	-145953	-50.44
675	51	ГРиС-Банк	1928	Ставропольский край	434826	655545	-220719	-33.67
472	3	Преодоление	2649	Москва и обл.	2584107	3070318	-486211	-15.84
304	13	Вега-Банк	3270	Москва и обл.	6700477	7476528	-776051	-10.38
391	19	Крыловский	456	Краснодарский край	3854733	4466572	-611839	-13.7
352	7	Уралкапиталбанк	2519	Башкортостан	5129346	5829072	-699726	-12
265	7	Екатеринбург	3161	Свердловская обл.	8796759	9705351	-908592	-9.36
388	16	Стройлесбанк	2995	Тюменская обл.	4009010	4638246	-629236	-13.57
324	6	Банкхаус Эрбе	1717	Москва и обл.	6094503	6873068	-778565	-11.33
50	1	РосЕвроБанк	3137	Москва и обл.	157642303	161427068	-3784765	-2.34
309	10	Роспромбанк	3204	Москва и обл.	6590435	7400357	-809922	-10.94
271	3	ЯР-Банк	3185	Москва и обл.	8458492	9377839	-919347	-9.8
558	9	ИК Банк	1732	Татарстан	1535155	1962222	-427067	-21.76
187	2	Денизбанк Москва	3330	Москва и обл.	18122511	19484276	-1361765	-6.99
52	0	Национальный Расчетный Депозитарий	3294	Москва и обл.	152226739	156105758	-3879019	-2.48
237	13	ЕвроситиБанк	1869	Москва и обл.	10908772	12033571	-1124799	-9.35
677	42	Промсвязьинвест	2761	Дагестан	416824	690550	-273726	-39.64
347	0	Сити Инвест Банк	3194	Санкт-Петербург и обл.	5290843	6123598	-832755	-13.6
500	-6	Вкабанк	1027	Астраханская обл.	2228103	2802101	-573998	-20.48
590	0	Максима	3379	Москва и обл.	1181475	1621804	-440329	-27.15
428	-4	Ермак	1809	Ханты-Мансийский АО — Югра	3319390	4022920	-703530	-17.49
308	6	Бинбанк Мурманск	1276	Мурманская обл.	6591681	7570037	-978356	-12.92
364	3	Москва-Сити	3247	Москва и обл.	4749690	5601533	-851843	-15.21
97	4	Международный Банк Санкт-Петербурга (МБСП)	197	Санкт-Петербург и обл.	53566090	56310956	-2744866	-4.87
244	9	Александровский	53	Санкт-Петербург и обл.	10559753	11835828	-1276075	-10.78
511	-3	Современные Стандарты Бизнеса	3397	Москва и обл.	2042670	2654805	-612135	-23.06
392	9	Кузнецкий Мост	2254	Москва и обл.	3846924	4675024	-828100	-17.71
710	74	НКО «МОБИ.Деньги»	3523	Москва и обл.	101768	322896	-221128	-68.48
61	0	Инвестторгбанк	2763	Москва и обл.	124351866	128769999	-4418133	-3.43
255	5	Кредит-Москва	5	Москва и обл.	9278911	10555326	-1276415	-12.09
554	-1	Коммерческий Банк Развития	3364	Москва и обл.	1545235	2118838	-573603	-27.07
166	-6	Морской Банк	77	Москва и обл.	23470795	25479636	-2008841	-7.88
173	-7	Спурт Банк	2207	Татарстан	21729708	23673137	-1943429	-8.21
208	1	Росдорбанк	1573	Москва и обл.	14985395	16615784	-1630389	-9.81
203	0	Норвик Банк	902	Кировская обл.	15312834	16960443	-1647609	-9.71
204	0	Гранд Инвест Банк	3053	Москва и обл.	15255556	16904531	-1648975	-9.75
483	-15	Столичный Кредит	2853	Москва и обл.	2450587	3197747	-747160	-23.37
355	-4	Банк БЦК-Москва	3480	Москва и обл.	5032427	6061819	-1029392	-16.98
664	25	Интеркоопбанк	2803	Москва и обл.	502972	905246	-402274	-44.44
286	3	Углеметбанк	2997	Челябинская обл.	7521772	8785642	-1263870	-14.39
517	-13	Финансовый Капитал	3288	Санкт-Петербург и обл.	2001445	2706649	-705204	-26.05
615	-10	Севзапинвестпромбанк	2152	Санкт-Петербург и обл.	954616	1478242	-523626	-35.42
662	22	Международный Расчетный Банк	3028	Москва и обл.	513357	929718	-416361	-44.78
201	0	Форштадт	2208	Оренбургская обл.	15437483	17233533	-1796050	-10.42
290	2	Экспресс-Кредит	210	Москва и обл.	7294232	8565396	-1271164	-14.84
348	-6	НБК-Банк	3283	Москва и обл.	5254978	6361532	-1106554	-17.39
462	-20	Банк Экономический Союз	2798	Москва и обл.	2777152	3633857	-856705	-23.58
128	5	Советский	558	Санкт-Петербург и обл.	35250592	38084983	-2834391	-7.44
363	-7	Банк Инноваций и Развития	2647	Москва и обл.	4777648	5898249	-1120601	-19
656	8	Лидер	3304	Москва и обл.	582735	1077125	-494390	-45.9
230	6	Стратегия	2801	Москва и обл.	11425221	13209365	-1784144	-13.51
569	-22	Кредитинвест	1197	Дагестан	1422893	2145401	-722508	-33.68
707	40	Петербургский Расчетный Центр	3306	Санкт-Петербург и обл.	161218	516205	-354987	-68.77
409	-10	Межрегиональный Почтовый Банк	3171	Москва и обл.	3632492	4719434	-1086942	-23.03
17	-1	Банк «Санкт-Петербург»	436	Санкт-Петербург и обл.	549187807	561074163	-11886356	-2.12
67	4	Запсибкомбанк	918	Тюменская обл.	101284015	106730960	-5446945	-5.1
339	-10	Милбанк	3256	Москва и обл.	5514438	6906696	-1392258	-20.16
75	1	Центр-инвест	2225	Ростовская обл.	89213336	94367040	-5153704	-5.46
316	-9	Руснарбанк	3403	Москва и обл.	6411313	7915298	-1503985	-19
579	-20	Сталь Банк	2248	Москва и обл.	1275044	2059304	-784260	-38.08
163	-8	Региональный Кредит	1927	Костромская обл.	24119063	27000517	-2881454	-10.67
184	-6	БМВ Банк	3482	Москва и обл.	18849048	21422544	-2573496	-12.01
552	-33	Сельмашбанк	106	Ростовская обл.	1571993	2442496	-870503	-35.64
497	-33	Северо-Западный 1 Альянс Банк	766	Санкт-Петербург и обл.	2259821	3269429	-1009608	-30.88
14	-1	Райффайзенбанк	3292	Москва и обл.	874085221	890907411	-16822190	-1.89
171	-8	Альта-Банк	2269	Москва и обл.	22109373	24928411	-2819038	-11.31
507	-35	Единый Строительный Банк	3506	Омская обл.	2118402	3124858	-1006456	-32.21
74	1	Банк БФА	3038	Санкт-Петербург и обл.	89467395	95124346	-5656951	-5.95
31	-4	СМП Банк	3368	Москва и обл.	339534034	350586922	-11052888	-3.15
245	0	Унифин	2654	Москва и обл.	10412097	12513192	-2101095	-16.79
586	-24	Санкт-Петербургский Банк Инвестиций	3468	Санкт-Петербург и обл.	1195323	2050019	-854696	-41.69
140	3	БыстроБанк	1745	Удмуртия	29712502	33183552	-3471050	-10.46
26	0	Связь-Банк	1470	Москва и обл.	369750955	381751393	-12000438	-3.14
331	-18	ФДБ	3071	Москва и обл.	5856032	7573423	-1717391	-22.68
134	6	Банк СГБ	2816	Вологодская обл.	31312164	35028550	-3716386	-10.61
160	-10	Агропромкредит	2880	Москва и обл.	24977236	28351136	-3373900	-11.9
49	0	Кредит Европа Банк	3311	Москва и обл.	160362358	168649200	-8286842	-4.91
214	-4	ГПБ-Ипотека	2403	Москва и обл.	13827458	16501398	-2673940	-16.2
487	-46	Народный Банк	2249	Карачаево-Черкесия	2397401	3665447	-1268046	-34.59
387	-23	Международный Коммерческий Банк	2524	Москва и обл.	4072170	5651712	-1579542	-27.95
66	4	Сетелем Банк	2168	Москва и обл.	102941708	109990689	-7048981	-6.41
689	-17	Национальный Банк Сбережений	1949	Ивановская обл.	354638	1045431	-690793	-66.08
123	0	НС Банк	3124	Москва и обл.	37195488	41595729	-4400241	-10.58
121	-3	Меткомбанк (Череповец)	901	Вологодская обл.	38586489	43333860	-4747371	-10.96
281	-13	Финам Банк	2799	Москва и обл.	7765804	10056544	-2290740	-22.78
56	-3	Ренессанс Кредит	3354	Москва и обл.	146452707	155653377	-9200670	-5.91
233	-5	Национальная Факторинговая Компания	3437	Москва и обл.	11261621	14150522	-2888901	-20.42
450	-56	Оргбанк	3312	Москва и обл.	3070857	4799412	-1728555	-36.02
257	-6	Япы Креди Банк Москва	2555	Москва и обл.	9220459	11949279	-2728820	-22.84
549	-70	Мурманский Расчетный Центр	3341	Мурманская обл.	1589139	2992266	-1403127	-46.89
433	-56	Народный Доверительный Банк	2374	Москва и обл.	3302078	5248851	-1946773	-37.09
251	-11	Хованский	2145	Москва и обл.	9729713	12841381	-3111668	-24.23
424	-52	Новое Время	3492	Москва и обл.	3449432	5486170	-2036738	-37.12
266	-12	Мир Бизнес Банк	3396	Москва и обл.	8784113	11813497	-3029384	-25.64
186	-15	Банк Кредит Свисс	2494	Москва и обл.	18382752	22613053	-4230301	-18.71
71	1	Балтийский Банк	128	Санкт-Петербург и обл.	97386906	106611215	-9224309	-8.65
427	-56	Рапида	3371	Москва и обл.	3350860	5516177	-2165317	-39.25
132	3	М2М Прайвет Банк	1414	Москва и обл.	31904419	37580474	-5676055	-15.1
127	-3	Русский Международный Банк	3123	Москва и обл.	35266316	41227242	-5960926	-14.46
375	-47	Европлан Банк	3052	Москва и обл.	4478921	6940041	-2461120	-35.46
33	-3	Глобэкс	1942	Москва и обл.	284040902	300252095	-16211193	-5.4
297	-31	Голдман Сакс Банк	3490	Москва и обл.	7135798	10132960	-2997162	-29.58
267	-15	Гута-Банк	256	Москва и обл.	8652984	11931619	-3278635	-27.48
118	-6	Еврофинанс Моснарбанк	2402	Москва и обл.	40506119	47211123	-6705004	-14.2
126	-4	Фольксваген Банк Рус	3500	Москва и обл.	36107718	42490002	-6382284	-15.02
99	-2	Национальный Стандарт	3421	Москва и обл.	50892858	58419353	-7526495	-12.88
269	-20	Нефтепромбанк	2156	Москва и обл.	8584044	12046468	-3462424	-28.74
125	-5	Интерпромбанк	3266	Москва и обл.	36169587	42719294	-6549707	-15.33
321	-45	Банк ПСА Финанс Рус	3481	Москва и обл.	6197279	9335381	-3138102	-33.62
147	-5	Газбанк	2316	Самарская обл.	28091508	34250464	-6158956	-17.98
101	-3	Тойота Банк	3470	Москва и обл.	49878296	58069178	-8190882	-14.11
241	-19	Гаранти Банк — Москва	3275	Москва и обл.	10726813	14883224	-4156411	-27.93
370	-58	Заречье	817	Татарстан	4575485	7607914	-3032429	-39.86
167	-18	Платежный Центр	3166	Новосибирская обл.	22595297	28537142	-5941845	-20.82
480	-96	Еврокредит	2957	Москва и обл.	2519476	5089983	-2570507	-50.5
400	-66	Невский Банк	1068	Санкт-Петербург и обл.	3729647	6738807	-3009160	-44.65
439	-89	Международный Банк Развития	2704	Москва и обл.	3205280	6086251	-2880971	-47.34
34	-3	Зенит	3255	Москва и обл.	276777867	297131980	-20354113	-6.85
368	-65	Платина	2347	Москва и обл.	4630912	8095160	-3464248	-42.79
98	-5	Финпромбанк (ФПБ Банк)	2157	Москва и обл.	51505239	61260538	-9755299	-15.92
40	-6	Восточный Экспресс Банк	1460	Амурская обл.	226081496	248493729	-22412233	-9.02
234	-34	Автоторгбанк	2776	Москва и обл.	11234709	17245977	-6011268	-34.86
247	-33	Киви Банк	2241	Москва и обл.	10227569	16285275	-6057706	-37.2
634	-195	Жилстройбанк	2769	Москва и обл.	803677	3694561	-2890884	-78.25
64	0	Русфинанс Банк	1792	Самарская обл.	107382590	125753435	-18370845	-14.61
43	-6	Возрождение	1439	Москва и обл.	217271750	242891680	-25619930	-10.55
10	0	ЮниКредит Банк	1	Москва и обл.	1320713756	1384673921	-63960165	-4.62
108	-12	Меткомбанк (Каменск-Уральский)	2443	Свердловская обл.	46001656	59555603	-13553947	-22.76
135	-16	Собинбанк	1317	Москва и обл.	31244778	42816948	-11572170	-27.03
27	-6	Нордеа Банк	3016	Москва и обл.	369124223	411135893	-42011670	-10.22
48	-5	МТС Банк	2268	Москва и обл.	165189870	196252850	-31062980	-15.83
77	-8	Дойче Банк	3328	Москва и обл.	86758352	110494664	-23736312	-21.48
47	-5	ОТП Банк	2766	Москва и обл.	170545308	202889100	-32343792	-15.94
105	-17	Коммерцбанк (Евразия)	3333	Москва и обл.	47678680	67075851	-19397171	-28.92
9	0	Национальный Клиринговый Центр	3466	Москва и обл.	1397028289	1489477939	-92449650	-6.21
103	-16	Первобанк	3461	Самарская обл.	48267827	68918234	-20650407	-29.96
65	-7	ЦентроКредит	121	Москва и обл.	105749132	134705099	-28955967	-21.5
94	-10	Балтинвестбанк	3176	Санкт-Петербург и обл.	55956172	78325444	-22369272	-28.56
30	-5	МДМ Банк	323	Москва и обл.	341635505	392994541	-51359036	-13.07
325	-127	Объединенная Расчетная Система	3342	Москва и обл.	6015399	17478708	-11463309	-65.58
28	-6	Национальный Банк «Траст»	3279	Москва и обл.	347406759	407647186	-60240427	-14.78
298	-114	Кубаньторгбанк	478	Краснодарский край	7009508	20546014	-13536506	-65.88
7	0	Альфа-Банк	1326	Москва и обл.	2166341765	2312738407	-146396642	-6.33
13	-1	Росбанк	2272	Москва и обл.	885949682	983627067	-97677385	-9.93
130	-31	Натиксис Банк	3390	Москва и обл.	32853934	58046299	-25192365	-43.4
38	-10	Хоум Кредит Банк	316	Москва и обл.	266352218	334895610	-68543392	-20.47
157	-62	Королевский Банк Шотландии	2594	Москва и обл.	25218457	59620117	-34401660	-57.7
84	-21	Эйч-Эс-Би-Си Банк (HSBC)	3290	Москва и обл.	71604307	126298847	-54694540	-43.31
87	-21	Металлинвестбанк	2440	Москва и обл.	65108438	123521839	-58413401	-47.29
18	-4	Ханты-Мансийский банк Открытие	1971	Москва и обл.	511498142	793819868	-282321726	-35.56
8	-2	Банк Москвы	2748	Москва и обл.	1753618069	2419161370	-665543301	-27.51
